income,age,childrenhome,wine_products,fruit_products,meat_products,fish_products,sweet_products,gold_products,total_products,deal_purchases,web_purchases,catalog_purchases,store_purchases,total_purchases,web_visits_permonth,marital_status_Single,education_Higher Education,Cluster
46344.0,70,2,11,1,6,2,1,6,27,2,1,1,2,4,5,True,False,0
71613.0,59,0,426,49,127,111,21,42,776,1,8,2,10,20,4,False,False,2
26646.0,40,1,11,4,20,10,3,5,53,2,2,0,4,6,6,False,False,0
58293.0,43,1,173,43,118,46,27,15,422,5,5,3,6,14,5,False,True,1
62513.0,57,1,520,42,98,0,42,14,716,2,6,4,10,20,6,False,True,1
55635.0,53,1,235,65,164,50,49,27,590,4,7,3,7,17,6,True,False,2
33454.0,39,1,76,10,56,3,1,23,169,2,4,0,4,8,8,False,True,0
52028.5,41,1,5,5,6,0,2,1,19,1,1,0,2,3,7,False,False,0
7500.0,48,0,6,16,11,11,1,16,61,1,2,0,3,5,8,False,False,0
59354.0,72,2,233,2,53,3,5,14,310,3,6,1,5,12,6,True,True,1
17323.0,37,0,3,14,17,6,1,5,46,1,1,0,3,4,8,False,False,0
82800.0,78,0,1006,22,115,59,68,45,1315,1,7,6,12,25,3,True,True,2
41850.0,44,2,53,5,19,2,13,4,96,3,3,0,3,6,8,False,False,0
37760.0,78,0,84,5,38,150,12,28,317,2,4,1,6,11,7,False,False,1
33812.0,39,1,4,17,19,30,24,39,133,2,2,1,3,6,6,True,True,0
37040.0,42,0,86,2,73,69,38,48,316,1,4,2,5,11,8,False,False,0
58607.0,75,1,867,0,86,0,0,19,972,3,2,3,9,14,8,False,True,1
65324.0,70,1,384,0,102,21,32,5,544,3,6,2,9,17,4,False,True,1
18589.0,55,0,6,4,25,15,12,13,75,2,2,1,3,6,7,True,False,0
53359.0,48,2,173,4,30,3,6,41,257,4,5,1,4,10,7,False,False,1
38360.0,35,1,36,2,42,20,21,10,131,2,2,1,4,7,3,False,False,0
10979.0,35,0,8,4,10,2,2,4,30,2,3,0,3,6,5,True,True,0
38620.0,61,0,112,17,44,34,22,89,318,1,2,5,3,10,3,False,True,1
40548.0,54,1,110,0,5,2,0,3,120,2,2,1,4,7,5,False,False,0
46610.0,72,2,96,12,96,33,22,43,302,6,4,1,6,11,6,True,True,1
68657.0,78,0,482,34,471,119,68,22,1196,1,3,5,9,17,7,False,True,2
49389.0,73,2,40,0,19,2,1,3,65,1,2,0,3,5,7,True,True,0
67353.0,54,1,702,17,151,0,8,35,913,5,5,6,12,23,2,False,True,1
23718.0,48,1,6,3,14,15,7,36,81,3,3,1,2,6,7,False,True,0
42429.0,51,1,55,0,6,2,0,4,67,2,1,1,3,5,5,True,False,0
48948.0,81,0,437,8,206,160,49,42,902,2,7,10,5,22,6,True,True,2
20559.0,39,1,13,1,29,3,0,7,53,2,2,0,3,5,8,False,True,0
21994.0,67,1,9,0,6,3,1,3,22,1,0,0,3,3,5,False,False,0
55212.0,65,0,81,11,50,3,2,39,186,1,1,3,4,8,2,True,True,0
7500.0,49,1,3,1,10,3,2,12,31,3,2,0,3,5,5,False,True,0
52028.5,73,3,48,5,48,6,10,7,124,3,2,1,4,7,6,True,False,0
72550.0,70,2,826,50,317,50,38,38,1319,9,5,2,12,19,8,False,True,1
65486.0,67,1,245,19,125,37,67,14,507,1,4,2,10,16,2,True,False,2
35790.0,47,1,12,6,20,30,1,3,72,2,2,0,3,5,7,True,False,0
27938.0,36,1,13,0,8,2,1,5,29,1,1,0,4,5,3,True,False,0
52028.5,42,1,11,3,22,2,2,6,46,2,2,0,3,5,6,True,False,0
55954.0,56,1,447,0,28,0,0,43,518,3,8,2,6,16,7,False,True,1
66653.0,49,2,452,18,102,16,18,6,612,4,4,2,12,18,3,False,False,1
67680.0,73,1,546,0,48,0,6,6,606,1,7,3,8,18,5,True,True,1
25721.0,53,1,1,3,6,3,6,15,34,1,1,1,2,4,7,False,False,0
32474.0,57,2,10,0,1,0,0,0,11,1,1,0,2,3,7,False,False,0
88194.0,45,1,688,14,309,201,24,38,1274,1,11,10,10,31,5,True,True,2
74854.0,54,3,856,59,487,58,29,73,1562,7,2,5,5,12,5,False,False,2
66991.0,70,0,496,36,460,189,60,12,1253,3,4,8,6,18,3,False,True,2
46805.0,51,1,25,3,43,17,4,17,109,3,3,0,3,6,8,False,True,0
65031.0,65,1,258,107,291,84,37,86,863,4,10,3,13,26,7,False,False,2
60631.0,49,2,565,6,65,0,6,19,661,5,9,2,8,19,7,False,True,1
28332.0,72,0,14,10,13,4,15,9,65,1,2,1,4,7,2,False,False,0
40246.0,47,1,2,1,6,2,1,1,13,1,1,0,2,3,6,True,False,0
26326.0,48,0,1,0,5,0,3,9,18,1,0,0,3,3,3,False,True,0
56046.0,59,0,577,0,64,0,0,51,692,2,10,1,8,19,8,False,False,1
29760.0,39,1,64,4,68,7,5,17,165,4,3,1,4,8,8,True,False,0
26304.0,55,1,4,1,5,2,0,4,16,1,1,0,2,3,7,False,False,0
23559.0,51,1,25,5,19,7,0,23,79,3,3,0,3,6,7,False,True,0
38620.0,61,0,112,17,44,34,22,89,318,1,2,5,3,10,3,False,True,1
81361.0,37,0,163,23,424,27,65,76,778,1,3,10,13,26,1,True,False,2
29440.0,64,2,17,8,14,10,4,3,56,2,1,0,4,5,7,False,False,0
36138.0,54,2,130,0,16,0,0,5,151,5,3,1,4,8,7,False,True,0
50388.0,67,1,292,6,37,0,3,34,372,4,6,1,6,13,7,True,False,1
54178.0,57,1,135,9,39,4,0,7,194,1,2,2,5,9,2,False,False,0
52028.5,67,2,7,0,8,2,0,1,18,1,1,0,2,3,7,True,False,0
50943.0,51,0,445,37,359,98,28,18,985,1,2,4,8,14,1,False,True,2
42394.0,52,1,15,2,10,0,1,4,32,1,1,0,3,4,7,True,True,0
23626.0,54,1,27,2,14,0,0,0,43,3,3,1,3,7,5,False,True,0
30096.0,41,1,5,3,11,12,5,9,45,1,2,0,3,5,6,False,False,0
47916.0,64,1,505,0,26,0,0,75,606,5,7,4,6,17,6,True,False,1
51813.0,52,2,51,2,7,0,1,2,63,2,2,0,3,5,7,True,False,0
50150.0,41,0,135,46,92,65,61,11,410,2,5,2,7,14,5,False,True,2
47823.0,64,1,53,1,5,2,1,10,72,2,2,0,3,5,8,True,True,0
34554.0,65,1,41,1,6,2,0,5,55,2,2,0,3,5,6,True,True,0
65846.0,79,0,562,81,276,80,40,81,1120,1,6,3,6,15,4,False,True,2
24594.0,45,1,1,3,6,10,0,9,29,1,1,0,3,4,5,False,False,0
49096.0,60,2,144,1,32,2,1,7,187,4,4,1,4,9,7,False,False,0
38557.0,46,1,76,3,31,4,4,27,145,2,3,1,3,7,7,True,False,0
89058.0,64,0,454,194,106,31,22,43,850,1,5,4,4,13,2,False,True,2
77298.0,45,1,425,115,292,23,35,79,969,1,6,6,11,23,3,False,False,2
57288.0,61,1,527,0,21,0,0,60,608,3,8,1,8,17,6,False,True,1
86037.0,33,0,490,44,125,29,20,22,730,1,6,7,11,24,3,True,False,2
43974.0,44,1,378,0,101,0,0,72,551,5,6,4,6,16,7,False,True,1
50785.0,62,2,64,1,21,0,1,27,114,2,2,1,3,6,6,True,False,0
30753.0,57,2,12,5,25,0,9,30,81,2,1,1,3,5,5,False,True,0
21918.0,55,1,1,6,7,11,5,3,33,2,2,0,3,5,6,False,False,0
32557.0,57,1,34,3,29,0,4,10,80,3,2,1,3,6,5,True,True,0
19510.0,39,2,9,0,7,3,4,7,30,2,1,0,3,4,7,False,True,0
30992.0,48,1,17,0,14,7,3,2,43,1,1,0,3,4,7,True,False,0
54348.0,71,2,70,0,16,0,0,4,90,2,2,0,4,6,6,False,True,0
55212.0,63,1,352,0,27,10,0,15,404,3,6,1,7,14,6,False,True,1
77376.0,68,2,492,19,110,16,12,12,661,4,6,3,10,19,4,False,True,1
61331.0,66,2,534,5,47,0,5,41,632,5,11,1,6,18,8,True,True,1
41551.0,60,2,220,0,33,3,0,23,279,5,5,1,5,11,8,False,True,1
9548.0,48,1,0,1,3,10,6,9,29,2,1,0,3,4,8,True,False,0
33762.0,65,3,53,1,34,2,0,16,106,3,2,2,2,6,8,False,True,0
35860.0,51,2,15,0,8,4,2,20,49,2,1,1,2,4,5,True,True,0
36921.0,59,2,17,1,12,3,1,4,38,2,2,0,3,5,7,True,True,0
65104.0,48,1,738,0,232,13,20,50,1053,2,3,5,7,15,7,False,True,1
68352.0,50,1,614,16,132,43,33,33,871,3,8,5,9,22,6,True,True,1
59809.0,48,2,598,16,141,32,41,49,877,3,3,3,6,12,8,False,False,1
23957.0,49,1,2,1,18,20,11,16,68,1,2,0,3,5,6,False,False,0
38547.0,43,1,6,1,10,0,1,4,22,1,1,0,2,3,8,False,False,0
35688.0,51,3,73,3,90,12,1,32,211,7,4,1,4,9,8,False,True,1
49605.0,58,0,42,16,29,12,20,8,127,1,2,1,4,7,3,False,True,0
59354.0,71,2,295,21,78,39,13,13,459,1,4,4,7,15,3,False,True,1
65747.0,55,1,346,17,48,23,13,13,460,4,8,1,6,15,6,False,False,1
46344.0,52,1,233,20,57,8,20,91,429,4,7,1,5,13,7,False,True,1
34176.0,36,1,5,7,24,19,14,20,89,4,3,0,4,7,6,True,False,0
61010.0,72,1,888,0,57,0,0,76,1021,2,8,5,11,24,5,False,True,1
69372.0,75,0,997,26,269,34,13,42,1381,1,10,4,6,20,4,False,False,2
49967.0,66,1,212,6,69,4,12,3,306,3,6,1,5,12,7,True,False,1
60199.0,46,3,8,1,7,2,0,0,18,1,0,0,3,3,4,True,False,0
55375.0,47,1,42,11,57,10,28,14,162,1,1,1,6,8,2,False,False,0
30523.0,66,3,5,0,3,0,0,5,13,1,1,0,2,3,7,True,True,0
70356.0,79,0,1349,16,249,43,16,33,1706,2,10,6,9,25,6,False,True,2
23228.0,40,1,53,3,49,7,4,5,121,4,3,0,4,7,8,False,False,0
74165.0,49,0,1001,12,240,16,12,12,1293,1,5,4,10,19,2,True,True,2
43482.0,58,3,18,1,32,6,3,28,88,3,2,0,4,6,6,False,False,0
62551.0,71,0,125,16,98,134,21,27,421,1,6,7,4,17,3,True,False,2
52332.0,65,0,212,5,33,7,0,2,259,1,3,2,6,11,4,True,False,0
26091.0,67,2,15,10,19,8,17,20,89,3,2,1,3,6,5,False,False,0
33456.0,59,2,7,3,10,8,1,7,36,2,1,0,3,4,7,False,False,0
28718.0,42,1,12,4,6,11,8,16,57,2,2,0,3,5,8,False,False,0
50447.0,54,2,85,7,24,2,3,27,148,1,3,1,3,7,6,False,False,0
53537.0,65,2,81,0,6,0,0,6,93,2,2,1,3,6,5,False,True,0
52074.0,57,1,59,0,12,0,0,48,119,1,2,2,2,6,4,True,False,0
38853.0,54,2,29,0,14,0,0,2,45,2,2,0,3,5,7,False,True,0
38285.0,65,3,2,0,5,2,0,1,10,1,0,0,3,3,2,False,False,0
51650.0,48,1,152,3,22,2,5,7,191,1,4,1,4,9,5,False,True,0
16248.0,36,1,12,11,10,3,12,9,57,3,2,1,3,6,6,False,True,0
30477.0,40,1,47,1,6,0,0,12,66,1,1,1,3,5,6,False,True,0
28249.0,63,0,1,9,7,2,14,10,43,1,2,0,3,5,6,False,False,0
32303.0,54,1,35,0,2,0,0,2,39,2,1,0,4,5,5,True,True,0
45759.0,60,2,42,1,18,3,0,4,68,2,2,0,3,5,7,False,True,0
24882.0,46,1,1,4,10,29,0,36,80,1,1,1,2,4,6,False,False,0
38872.0,36,1,23,3,21,3,19,22,91,2,3,0,3,6,8,False,False,0
51148.0,51,2,235,6,45,8,9,12,315,4,5,1,6,12,6,False,False,1
31353.0,47,2,10,0,10,3,1,7,31,2,1,1,2,4,8,False,False,0
69661.0,44,0,656,16,106,32,16,8,834,1,7,3,12,22,3,False,True,2
46854.0,51,2,96,1,79,7,1,79,263,6,5,1,3,9,8,True,True,1
69142.0,72,1,448,4,34,6,4,39,535,3,8,1,7,16,5,True,False,1
40637.0,59,2,22,0,13,0,0,3,38,2,1,0,3,4,7,True,True,0
18890.0,40,0,6,4,1,7,2,15,35,1,0,1,2,3,6,True,True,0
48721.0,61,2,81,18,113,47,13,21,293,6,4,2,5,11,6,True,True,1
44794.0,58,1,54,0,7,0,0,4,65,1,2,0,3,5,6,False,False,0
46097.0,68,1,72,24,68,65,4,8,241,5,3,1,6,10,4,False,False,1
44377.0,56,2,224,0,30,0,0,10,264,8,5,1,5,11,8,False,True,1
46014.0,50,2,410,0,59,19,9,44,541,10,7,1,8,16,7,False,True,1
41443.0,47,1,171,7,171,25,19,89,482,6,8,1,5,14,8,False,False,1
52195.0,46,3,12,0,4,0,0,1,17,1,1,0,2,3,8,True,True,0
83790.0,76,0,1076,16,417,42,48,16,1615,1,8,10,6,24,3,False,True,2
44551.0,70,1,182,4,33,0,0,66,285,2,4,1,5,10,7,True,True,1
69508.0,44,1,824,32,162,42,32,43,1135,2,11,4,11,26,6,False,False,2
45204.0,36,1,30,11,25,29,1,18,114,1,1,1,4,6,3,False,True,0
77622.0,54,2,520,7,154,19,0,14,714,2,6,3,11,20,3,False,True,1
30732.0,44,1,155,1,25,0,1,3,185,4,4,1,4,9,8,False,True,0
63887.0,62,1,897,23,207,15,11,92,1245,5,9,6,12,27,6,True,False,1
42011.0,46,1,131,0,16,2,1,39,189,4,3,1,4,8,8,False,False,0
51537.0,72,1,787,20,204,0,0,92,1103,3,2,2,11,15,8,True,False,1
34320.0,38,1,4,1,9,3,0,0,17,1,1,0,2,3,8,False,True,0
37070.0,58,2,231,7,137,4,15,39,433,9,5,1,8,14,7,True,False,1
38590.0,53,1,3,1,8,4,3,3,22,1,1,0,2,3,8,False,False,0
15033.0,73,0,0,4,5,6,0,4,19,1,1,0,3,4,3,True,False,0
62745.0,59,1,562,21,464,28,10,32,1117,3,7,8,11,26,5,False,True,2
22212.0,49,1,5,9,20,6,8,21,69,2,2,0,4,6,6,False,True,0
23661.0,42,1,18,0,4,0,0,1,23,1,1,0,3,4,7,False,True,0
79761.0,66,1,415,5,124,15,35,11,605,1,5,2,11,18,3,True,True,1
7500.0,51,1,5,3,10,12,7,20,57,4,3,1,3,7,7,True,False,0
31686.0,60,2,11,0,5,0,0,1,17,2,1,0,3,4,6,False,True,0
80134.0,52,1,1218,16,272,104,0,80,1690,2,5,3,6,14,6,False,False,2
75027.0,71,1,925,64,179,133,12,77,1390,2,9,4,6,19,5,False,False,2
31160.0,49,1,16,3,25,6,1,13,64,2,2,0,3,5,8,True,True,0
29938.0,39,1,3,3,7,0,2,11,26,2,1,0,3,4,6,True,False,0
26490.0,66,0,45,47,52,21,20,25,210,2,3,1,5,9,6,False,True,0
75702.0,57,2,650,28,353,45,42,30,1148,5,4,6,11,21,8,False,False,2
30899.0,50,1,24,0,8,0,0,1,33,2,1,0,3,4,6,True,True,0
63342.0,63,1,918,21,118,13,10,21,1101,3,8,3,5,16,6,False,True,1
45989.0,60,1,138,33,87,28,24,12,322,4,3,2,7,12,3,True,False,1
18701.0,60,2,12,4,2,10,6,10,44,4,2,0,4,6,5,True,False,0
40737.0,67,3,11,0,4,0,0,2,17,1,1,0,2,3,8,True,True,0
15287.0,45,1,1,2,8,4,3,13,31,2,1,1,2,4,7,True,False,0
69674.0,56,2,554,41,215,11,0,24,845,3,10,2,10,22,5,True,True,1
44159.0,54,1,167,2,62,24,13,7,275,4,4,1,6,11,5,False,True,1
43776.0,72,2,177,2,71,3,2,20,275,6,5,2,4,11,8,False,True,1
38179.0,58,2,38,4,22,4,2,20,90,4,3,1,3,7,7,False,True,0
38097.0,54,2,77,2,35,0,1,69,184,4,3,2,2,7,7,False,True,0
22070.0,54,1,10,7,19,8,2,21,67,2,2,2,2,6,6,False,False,0
31788.0,41,1,16,7,23,0,8,6,60,3,3,0,4,7,5,True,True,0
61905.0,49,1,167,0,43,6,2,13,231,2,4,2,4,10,5,False,True,0
29315.0,64,2,13,2,14,8,7,4,48,4,2,0,4,6,6,False,False,0
33378.0,61,2,33,6,40,3,7,10,99,3,2,0,4,6,7,True,False,0
66313.0,61,1,625,7,99,10,22,7,770,2,6,3,12,21,4,False,True,1
77882.0,43,0,68,129,396,188,22,15,818,1,3,3,5,11,1,False,True,2
24480.0,43,1,4,19,9,28,25,17,102,3,3,0,4,7,7,False,False,0
37760.0,78,0,84,5,38,150,12,28,317,2,4,1,6,11,7,False,False,1
65640.0,50,1,204,7,149,20,15,66,461,1,5,1,8,14,2,False,True,1
44319.0,49,2,26,0,8,0,0,3,37,2,2,0,3,5,5,False,True,0
30631.0,50,1,15,6,20,4,5,20,70,1,3,1,2,6,7,False,False,0
35416.0,75,0,248,3,81,4,3,51,390,3,7,1,5,13,8,True,True,1
32414.0,40,0,20,6,5,0,9,12,52,1,1,0,3,4,7,False,True,0
38361.0,55,1,39,0,56,20,8,14,137,3,3,1,3,7,7,False,False,0
29672.0,59,2,9,1,3,0,4,8,25,1,0,0,3,3,6,False,False,0
55951.0,72,1,1241,0,80,0,13,40,1374,3,3,6,11,20,8,False,True,1
35388.0,36,1,6,4,7,4,3,8,32,1,1,0,3,4,7,True,True,0
42386.0,38,1,65,4,16,0,4,11,100,1,3,0,3,6,8,False,True,0
68627.0,42,0,395,15,263,60,54,38,825,1,2,3,6,11,1,True,False,2
57912.0,59,1,801,0,80,0,0,35,916,5,8,3,12,23,5,True,True,1
35246.0,66,2,36,0,12,2,2,10,62,4,3,1,3,7,5,True,False,0
58821.0,68,1,513,14,154,19,0,28,728,1,9,2,9,20,6,False,True,1
46377.0,46,1,37,0,46,4,3,0,90,1,2,1,3,6,4,False,True,0
39747.0,36,1,80,15,93,20,13,52,273,3,5,1,4,10,8,True,False,0
23976.0,40,1,14,1,21,2,3,25,66,3,3,1,3,7,7,False,False,0
77457.0,77,0,675,11,400,15,45,11,1157,1,2,5,10,17,1,True,False,2
64100.0,60,1,509,0,27,0,0,10,546,1,8,3,6,17,7,False,True,1
42670.0,32,0,154,2,46,20,4,15,241,1,4,2,4,10,4,False,True,0
12571.0,48,1,3,5,14,2,12,17,53,4,3,1,3,7,6,True,False,0
22574.0,57,3,25,0,8,2,0,2,37,2,2,0,3,5,7,False,False,0
52028.5,35,0,861,138,461,60,30,61,1611,1,6,5,12,23,3,False,False,2
54198.0,58,2,185,0,28,3,2,17,235,6,3,1,6,10,4,False,False,1
28839.0,68,2,24,0,7,0,0,1,32,2,2,0,3,5,5,False,True,0
40321.0,52,2,44,4,21,6,0,27,102,2,3,0,3,6,7,False,False,0
66503.0,39,1,91,64,128,65,3,50,401,2,4,3,6,13,3,True,False,2
30833.0,73,2,11,0,7,3,1,6,28,2,1,0,3,4,5,False,False,0
52028.5,54,3,738,20,172,52,50,20,1052,6,2,3,10,15,7,True,False,1
64795.0,53,1,412,5,119,38,29,77,680,3,3,3,12,18,2,False,False,2
34421.0,50,1,3,3,7,6,2,9,30,1,1,0,2,3,7,False,False,0
47025.0,59,2,16,0,3,0,0,1,20,1,1,0,2,3,7,True,True,0
64325.0,63,1,731,60,353,78,12,73,1307,5,10,3,5,18,7,True,True,2
40464.0,71,1,424,17,118,7,23,41,630,6,8,2,8,18,8,True,False,1
14849.0,48,1,21,2,28,3,2,9,65,3,2,0,4,6,8,True,True,0
27255.0,40,1,22,1,11,0,1,2,37,1,1,0,3,4,7,False,False,0
54432.0,74,3,33,0,5,0,0,0,38,1,1,0,3,4,4,False,True,0
29999.0,38,1,68,7,59,10,5,11,160,4,3,1,4,8,8,True,True,0
24072.0,41,1,9,1,6,3,0,4,23,1,1,0,2,3,8,True,False,0
33996.0,35,0,40,2,15,8,0,6,71,1,1,1,3,5,4,True,True,0
66334.0,68,1,909,11,218,0,0,23,1161,2,9,3,5,17,5,False,True,1
35178.0,53,1,23,1,13,2,2,18,59,1,1,1,2,4,7,False,True,0
22010.0,41,1,11,2,9,3,0,8,33,2,2,0,3,5,8,False,False,0
30675.0,52,1,10,2,16,11,2,21,62,1,1,0,3,4,8,False,False,0
41411.0,38,0,37,32,38,11,3,18,139,1,2,1,4,7,6,True,False,0
55212.0,55,1,1103,0,45,0,0,34,1182,3,4,2,11,17,8,False,True,1
59292.0,74,1,378,14,68,19,14,14,507,2,3,5,8,16,3,False,True,1
27190.0,51,1,1,6,7,0,1,3,18,1,1,0,2,3,8,False,False,0
44300.0,59,2,30,0,9,0,0,3,42,2,1,0,3,4,6,False,False,0
30372.0,53,2,15,0,12,7,3,7,44,3,2,0,3,5,7,True,False,0
33181.0,48,1,9,0,3,0,0,4,16,1,1,0,2,3,6,False,True,0
71113.0,67,1,495,33,255,11,33,8,835,4,6,7,9,22,4,False,False,2
72099.0,50,0,546,91,410,119,0,22,1188,1,3,4,10,17,1,False,False,2
60000.0,48,1,1048,0,217,0,0,12,1277,5,11,3,5,19,6,True,True,1
38643.0,46,2,22,2,14,0,1,10,49,2,2,0,3,5,7,True,False,0
50737.0,69,1,78,0,11,0,0,10,99,1,2,0,4,6,6,False,False,0
65073.0,81,0,629,17,177,69,0,8,900,1,5,3,5,13,2,False,True,2
46681.0,76,2,269,15,69,15,19,38,425,2,4,6,4,14,5,False,True,1
62187.0,55,1,512,0,83,0,0,41,636,3,6,2,10,18,4,True,True,1
28442.0,46,2,19,3,10,11,8,6,57,3,2,1,4,7,4,False,False,0
51479.0,57,2,247,8,160,6,8,65,494,7,6,3,6,15,7,False,False,1
31615.0,48,1,2,3,20,6,11,9,51,2,2,0,3,5,7,True,False,0
52614.0,49,1,789,0,142,12,9,38,990,2,2,4,8,14,8,True,True,1
35684.0,40,1,10,4,7,0,6,3,30,1,1,0,3,4,6,False,True,0
48178.0,49,2,159,4,45,6,2,38,254,6,5,1,4,10,8,False,False,1
29548.0,54,1,7,1,6,3,1,11,29,1,1,1,2,4,4,True,True,0
38578.0,52,2,38,4,22,3,3,3,73,3,3,0,3,6,8,True,True,0
46098.0,49,2,57,0,27,0,0,36,120,4,3,2,2,7,8,True,True,0
30279.0,35,1,10,4,14,4,4,1,37,1,1,0,3,4,8,True,False,0
30822.0,55,1,3,9,13,2,12,12,51,1,1,0,3,4,7,True,False,0
33581.0,55,2,11,0,5,0,0,1,17,1,1,0,2,3,8,False,True,0
19986.0,39,1,3,6,5,0,2,6,22,1,0,0,3,3,7,False,False,0
27421.0,70,0,43,12,96,78,40,55,324,3,4,1,6,11,7,True,False,1
35688.0,51,3,73,3,90,12,1,32,211,7,4,1,4,9,8,False,True,1
36143.0,43,1,12,0,1,0,0,6,19,1,0,1,2,3,3,True,True,0
10245.0,53,1,4,7,7,6,4,13,41,3,1,2,2,5,5,True,False,0
38823.0,75,1,70,0,11,2,8,23,114,1,2,1,3,6,6,False,False,0
83664.0,56,2,866,21,151,28,21,86,1173,3,2,2,12,16,5,True,True,1
62499.0,45,1,140,4,61,0,13,4,222,2,3,1,6,10,4,False,True,0
51012.0,78,0,102,9,63,2,9,24,209,1,4,1,4,9,6,False,True,0
70777.0,56,1,554,35,113,0,7,78,787,3,5,3,12,20,3,False,True,1
43824.0,53,2,96,1,42,12,3,32,186,4,3,1,4,8,8,False,False,0
15345.0,40,1,5,2,16,3,2,19,47,2,1,1,2,4,8,False,False,0
23442.0,37,1,2,0,6,8,6,5,27,1,1,0,3,4,7,True,False,0
14515.0,44,1,6,4,9,6,36,35,96,4,2,2,3,7,7,False,True,0
31395.0,68,2,23,1,25,0,8,7,64,4,2,1,3,6,6,True,True,0
75276.0,59,0,610,105,125,137,42,21,1040,1,9,4,9,22,5,False,False,2
42373.0,50,2,67,5,61,3,8,19,163,5,2,1,5,8,5,True,False,0
55521.0,69,3,416,0,26,0,0,4,446,9,6,3,6,15,7,True,True,1
48006.0,59,2,23,0,11,3,2,2,41,1,1,0,3,4,6,False,False,0
27213.0,52,1,19,3,26,10,9,3,70,3,2,0,4,6,8,True,True,0
65808.0,53,2,155,7,80,13,7,10,272,3,5,1,5,11,6,True,True,1
50437.0,61,2,370,9,92,6,9,4,490,3,7,1,8,16,7,False,False,1
23616.0,42,1,4,22,11,3,7,32,79,2,3,0,3,6,8,True,True,0
66465.0,69,1,1200,0,204,38,29,14,1485,3,11,9,12,32,6,False,True,2
19789.0,49,1,2,5,9,28,6,28,78,3,2,1,3,6,5,False,True,0
80134.0,30,0,966,26,282,52,26,26,1378,1,2,7,11,20,5,False,False,2
49505.0,53,2,604,0,100,19,0,28,751,9,10,2,8,20,8,False,True,1
37401.0,51,1,19,3,19,3,1,3,48,2,2,0,3,5,7,False,True,0
30096.0,41,1,5,3,11,12,5,9,45,1,2,0,3,5,6,False,False,0
18492.0,42,1,2,2,2,2,1,1,10,1,1,0,2,3,8,False,True,0
48686.0,71,3,10,0,7,2,0,1,20,1,1,0,2,3,8,False,False,0
75433.0,35,1,800,0,297,0,34,57,1188,2,2,5,10,17,6,False,False,2
10404.0,35,1,2,2,11,10,6,12,43,2,1,0,4,5,5,False,True,0
84865.0,63,0,1248,16,349,43,16,16,1688,1,2,4,9,15,4,True,True,2
30015.0,54,1,25,0,22,2,3,5,57,2,1,0,4,5,5,True,False,0
50943.0,68,1,31,0,7,2,0,6,46,1,1,0,3,4,5,False,True,0
67272.0,58,1,357,35,271,28,28,14,733,3,6,2,12,20,5,True,False,2
51529.0,75,1,400,4,35,6,0,22,467,2,9,1,5,15,8,True,True,1
32011.0,53,1,99,0,15,2,1,5,122,3,2,1,4,7,7,False,True,0
7500.0,38,1,1,11,5,4,6,9,36,2,2,0,3,5,8,False,True,0
28691.0,35,1,5,4,13,8,0,4,34,1,1,0,3,4,8,False,False,0
56223.0,76,1,77,28,31,16,0,4,156,2,2,1,5,8,4,False,True,0
18100.0,78,0,3,1,2,4,3,1,14,1,0,0,3,3,5,False,False,0
30279.0,35,1,10,4,14,4,4,1,37,1,1,0,3,4,8,True,False,0
20130.0,50,0,0,6,3,7,6,12,34,1,1,0,3,4,8,False,True,0
23295.0,65,0,0,0,1,2,12,5,20,1,1,0,2,3,8,True,False,0
42618.0,52,1,76,14,74,13,5,10,192,2,5,0,4,9,8,True,True,0
24027.0,48,1,14,7,11,11,0,5,48,2,2,0,3,5,8,False,False,0
55707.0,71,1,208,7,82,30,66,35,428,2,3,2,9,14,3,False,True,2
57959.0,69,1,430,16,322,43,24,33,868,5,4,7,11,22,3,True,False,2
56796.0,55,1,656,38,161,62,47,37,1001,3,8,9,7,24,7,False,False,2
36230.0,53,1,14,2,30,8,2,3,59,1,2,0,4,6,5,True,True,0
70829.0,44,2,141,70,106,72,19,23,431,2,4,2,8,14,3,False,True,2
65991.0,48,1,507,19,364,25,47,9,971,3,9,5,10,24,7,False,False,2
38988.0,52,3,164,24,103,12,3,42,348,7,5,1,6,12,8,False,False,1
42207.0,40,1,116,11,72,3,17,46,265,4,4,1,5,10,6,False,True,1
50300.0,72,1,143,15,60,24,23,5,270,2,2,1,8,11,2,False,False,1
60597.0,60,1,522,0,257,32,16,66,893,4,2,2,8,12,7,False,False,1
50520.0,66,1,112,0,6,2,1,14,135,2,3,1,3,7,6,True,True,0
33183.0,49,1,7,5,39,17,15,37,120,2,4,0,3,7,7,False,False,0
66582.0,55,0,789,25,420,16,38,0,1288,1,2,8,9,19,1,True,True,2
75261.0,69,0,1239,17,413,23,34,17,1743,1,5,6,5,16,2,False,True,2
31880.0,54,1,4,1,5,2,0,3,15,1,1,0,2,3,8,True,False,0
53790.0,73,2,335,42,127,28,5,5,542,3,7,2,8,17,6,False,False,1
49269.0,53,1,639,8,166,11,8,58,890,3,7,3,12,22,7,False,True,1
37406.0,44,1,2,0,8,2,2,3,17,1,1,0,2,3,8,False,False,0
56937.0,43,1,746,8,125,11,8,8,906,7,8,6,9,23,6,False,True,1
38415.0,46,2,22,1,13,4,0,4,44,2,1,0,3,4,7,False,False,0
20518.0,36,1,4,1,6,4,1,9,25,1,1,1,2,4,5,True,False,0
41644.0,52,2,20,3,4,2,0,2,31,2,1,0,3,4,3,True,True,0
55842.0,47,1,451,0,39,0,4,24,518,1,7,1,8,16,5,False,True,1
62010.0,52,1,371,22,39,6,0,92,530,4,6,2,7,15,5,False,True,1
38961.0,51,1,19,7,19,0,1,24,70,1,2,1,2,5,7,False,True,0
37760.0,52,1,26,3,13,2,10,0,54,1,2,0,3,5,6,True,True,0
43057.0,49,1,213,2,44,0,2,5,266,4,4,2,5,11,5,False,False,0
78825.0,60,0,483,74,114,169,37,18,895,1,5,10,13,28,3,True,True,2
65104.0,48,1,738,0,232,13,20,50,1053,2,3,5,7,15,7,False,True,1
60093.0,50,1,502,12,109,16,6,90,735,2,7,2,10,19,6,False,False,1
14045.0,55,1,11,0,5,2,1,1,20,1,1,0,3,4,7,False,False,0
28457.0,72,0,24,1,108,29,29,14,205,1,4,1,4,9,8,True,True,0
46310.0,48,1,185,2,88,15,5,14,309,2,6,1,5,12,8,True,False,0
76005.0,69,0,983,20,389,240,50,40,1722,1,3,5,13,21,6,False,False,2
55614.0,80,0,504,13,131,8,0,26,682,1,9,4,6,19,7,True,True,1
59432.0,62,1,317,25,265,25,19,12,663,3,5,3,11,19,5,True,True,1
55563.0,46,1,29,1,9,2,0,2,43,1,2,0,3,5,3,True,False,0
78642.0,53,1,1396,0,322,46,35,17,1816,1,4,9,4,17,6,False,True,2
67911.0,75,1,529,0,356,63,28,0,976,3,6,7,11,24,3,False,True,2
65275.0,80,0,388,14,218,91,14,21,746,1,4,3,13,20,2,False,False,2
27203.0,74,2,13,2,21,4,0,24,64,2,1,1,2,4,8,False,False,0
48330.0,63,1,28,0,4,0,0,0,32,1,1,0,3,4,5,False,True,0
50943.0,68,1,31,0,7,2,0,6,46,1,1,0,3,4,5,False,True,0
65665.0,48,1,225,162,387,106,36,29,945,1,5,10,8,23,3,False,False,2
81217.0,35,0,493,70,324,146,40,84,1157,1,3,7,11,21,1,True,False,2
34935.0,32,0,34,4,66,3,10,20,137,1,2,1,4,7,7,False,False,0
61250.0,65,1,382,138,65,60,26,59,730,6,5,2,12,19,5,True,False,2
39665.0,43,1,127,1,56,0,1,31,216,3,4,2,3,9,7,False,True,0
60152.0,45,1,325,83,300,86,58,91,943,1,6,4,12,22,3,True,False,2
48920.0,60,2,238,17,68,8,10,6,347,3,6,2,5,13,7,False,False,1
44124.0,78,1,284,0,55,0,6,52,397,4,6,2,5,13,8,False,True,1
36443.0,63,2,65,0,46,4,3,20,138,4,3,1,3,7,8,False,False,0
26095.0,34,1,11,7,9,3,1,11,42,1,1,0,3,4,7,True,False,0
71367.0,65,0,227,23,389,42,21,75,777,1,4,5,7,16,2,False,False,2
30630.0,59,2,27,1,12,2,0,10,52,2,2,0,3,5,7,True,False,0
42691.0,33,0,179,2,64,38,17,58,358,1,5,1,6,12,5,False,False,1
70503.0,71,0,1379,33,216,0,33,66,1727,1,2,4,9,15,6,False,False,2
25545.0,37,1,32,1,64,16,12,85,210,3,2,2,3,7,6,False,False,0
32880.0,38,1,8,4,15,7,6,2,42,1,1,0,3,4,8,False,False,0
77863.0,66,0,881,38,319,16,25,12,1291,1,4,5,10,19,2,False,True,2
50353.0,47,0,141,15,153,67,31,35,442,1,4,4,6,14,3,False,True,2
49154.0,64,2,206,10,67,30,27,71,411,6,4,1,8,13,6,False,True,1
47682.0,49,1,162,61,83,97,57,61,521,4,4,3,8,15,5,True,True,2
72679.0,55,1,619,54,260,127,54,54,1168,1,4,7,5,16,1,True,False,2
57954.0,47,2,456,4,24,0,0,9,493,7,8,2,6,16,7,False,True,1
65316.0,62,2,112,6,92,3,9,38,260,2,3,2,5,10,4,False,False,1
28567.0,42,1,11,3,22,2,2,6,46,2,2,0,3,5,6,True,False,0
47352.0,73,1,172,12,112,8,0,15,319,4,6,1,5,12,7,False,True,1
44931.0,57,1,78,0,11,0,0,7,96,1,2,1,3,6,5,False,False,0
76982.0,57,0,464,151,292,65,60,30,1062,1,8,3,4,15,4,True,False,2
57247.0,72,1,99,4,32,37,54,6,232,2,2,1,7,10,2,False,True,1
22944.0,43,1,19,3,19,4,5,26,76,3,3,0,3,6,7,True,True,0
25315.0,47,1,1,9,8,11,3,22,54,3,3,0,3,6,8,False,True,0
43638.0,55,1,63,10,83,7,19,19,201,2,4,1,4,9,7,True,False,0
84169.0,42,0,1478,19,403,0,19,0,1919,1,7,6,6,19,3,False,True,2
24683.0,34,1,8,4,10,6,7,6,41,2,2,0,4,6,5,False,True,0
47850.0,44,1,42,7,43,20,12,10,134,1,3,0,4,7,6,False,False,0
19514.0,56,2,14,3,21,2,1,28,69,4,3,1,2,6,8,False,False,0
27159.0,51,2,17,0,3,0,0,1,21,2,1,0,3,4,6,False,True,0
39548.0,61,2,15,4,10,3,4,18,54,2,1,1,3,5,3,True,True,0
21474.0,35,1,6,16,24,11,0,34,91,2,3,1,2,6,7,True,False,0
60504.0,53,1,458,0,24,6,4,34,526,2,6,2,8,16,6,True,True,1
22419.0,61,0,30,3,47,19,21,42,162,1,3,2,2,7,8,False,False,0
43462.0,72,2,90,17,97,15,6,15,240,6,4,1,5,10,8,False,False,1
15315.0,54,0,7,4,13,15,8,17,64,2,2,0,4,6,5,False,True,0
87771.0,65,1,1492,38,287,50,57,33,1957,1,5,10,4,19,6,False,False,2
33039.0,46,1,30,8,12,8,8,12,78,1,2,0,4,6,5,False,False,0
71499.0,53,1,465,25,132,136,0,37,795,2,8,3,13,24,4,False,True,2
48799.0,61,1,174,18,81,28,6,24,331,3,3,2,7,12,3,True,True,1
52157.0,74,1,189,2,29,3,2,40,265,2,3,2,5,10,4,False,True,1
66565.0,62,1,747,10,161,65,40,42,1065,4,4,2,9,15,8,True,False,1
29298.0,73,2,6,0,2,2,0,1,11,1,1,0,2,3,5,False,True,0
47691.0,45,1,14,0,3,0,0,4,21,1,1,0,2,3,6,True,False,0
38200.0,54,2,12,0,4,0,0,1,17,1,1,0,2,3,7,False,False,0
38443.0,56,2,32,0,5,0,0,1,38,2,1,0,3,4,7,False,True,0
38593.0,46,1,51,12,49,17,24,24,177,3,4,1,3,8,8,True,True,0
64413.0,54,1,200,5,44,0,10,20,279,1,5,1,5,11,5,False,True,1
36959.0,43,1,25,6,25,6,0,0,62,2,2,0,3,5,8,False,True,0
61996.0,47,1,1050,12,144,0,0,24,1230,3,6,4,8,18,5,False,True,1
51287.0,56,2,117,0,22,13,0,30,182,3,4,1,3,8,7,False,False,0
13260.0,54,2,9,4,17,10,2,7,49,4,3,0,3,6,8,False,False,0
47472.0,58,2,56,0,11,0,0,8,75,2,2,0,4,6,5,False,True,0
54603.0,68,2,145,13,46,17,2,4,227,6,4,2,4,10,7,False,True,1
45207.0,50,2,203,0,10,0,0,2,215,5,3,1,6,10,6,False,True,0
47821.0,57,2,9,0,16,6,6,10,47,1,1,0,3,4,8,False,True,0
27450.0,73,0,37,12,23,8,11,52,143,1,2,1,3,6,7,False,True,0
39453.0,41,1,46,0,7,0,0,2,55,2,2,0,3,5,6,False,False,0
26850.0,53,2,31,1,13,7,2,9,63,4,2,1,4,7,4,False,True,0
61794.0,63,1,264,47,188,54,47,11,611,2,4,4,10,18,2,False,True,2
53863.0,69,1,399,4,30,6,4,30,473,3,7,1,7,15,7,False,False,1
24221.0,65,0,8,9,9,2,5,22,55,1,1,1,3,5,4,False,False,0
39684.0,40,1,19,0,35,6,4,17,81,2,2,1,2,5,7,True,True,0
33178.0,47,1,12,6,2,11,2,16,49,1,1,0,3,4,4,False,False,0
59973.0,52,0,130,30,168,20,34,0,382,1,3,4,7,14,1,False,True,2
17459.0,49,1,6,4,16,3,10,30,69,3,3,1,2,6,7,False,True,0
23910.0,55,1,16,12,18,7,1,13,67,1,2,0,3,5,7,True,False,0
42169.0,55,2,19,0,9,0,0,2,30,2,1,0,3,4,8,False,True,0
26224.0,46,1,4,7,15,13,9,15,63,3,2,1,3,6,6,False,True,0
31089.0,43,1,31,3,31,2,8,4,79,3,3,0,4,7,8,False,False,0
30081.0,63,1,36,0,2,0,0,4,42,1,1,0,3,4,7,True,False,0
61467.0,76,2,410,16,114,0,5,49,594,3,5,2,10,17,5,False,True,1
49618.0,58,2,80,3,26,4,2,14,129,4,3,1,3,7,7,False,True,0
42429.0,51,1,55,0,6,2,0,4,67,2,1,1,3,5,5,True,False,0
26150.0,68,3,5,1,13,3,5,1,28,1,1,0,3,4,7,True,False,0
30801.0,49,1,8,4,5,15,2,11,45,2,1,0,3,4,7,False,False,0
26877.0,55,0,101,13,76,20,18,40,268,2,3,1,6,10,6,True,True,0
45006.0,80,0,162,25,53,16,0,10,266,1,3,1,7,11,3,True,True,0
18978.0,51,1,2,8,1,4,7,15,37,1,1,0,3,4,8,False,False,0
22574.0,57,3,25,0,8,2,0,2,37,2,2,0,3,5,7,False,False,0
48240.0,55,0,389,91,248,64,49,41,882,3,6,3,13,22,5,True,True,2
45837.0,50,2,215,13,87,17,17,24,373,5,6,2,5,13,7,False,False,1
35791.0,59,3,27,0,5,0,0,3,35,2,1,0,3,4,8,True,True,0
54162.0,46,2,5,6,10,6,5,10,42,1,1,0,3,4,4,True,False,0
30522.0,64,1,179,8,83,19,11,26,326,5,1,2,9,12,2,False,True,1
54456.0,63,1,352,0,27,10,0,15,404,3,6,1,7,14,6,False,True,1
31632.0,53,0,17,8,12,11,15,32,95,1,2,1,2,5,7,True,False,0
72298.0,75,0,625,35,169,58,17,35,939,1,4,3,6,13,1,True,False,2
36975.0,46,1,10,6,11,0,4,2,33,1,1,0,3,4,7,True,True,0
13624.0,48,1,10,2,15,2,1,6,36,2,2,0,3,5,6,False,False,0
69084.0,54,1,1181,107,199,39,30,30,1586,2,7,3,13,23,8,False,True,2
65488.0,66,0,603,45,207,36,18,54,963,1,3,4,6,13,1,False,True,2
32218.0,64,0,10,24,15,13,1,30,93,1,2,1,3,6,7,True,True,0
46102.0,62,3,14,0,1,0,0,1,16,1,1,0,2,3,7,True,False,0
56181.0,62,1,121,103,69,8,44,48,393,1,4,2,7,13,4,False,False,2
63120.0,74,1,965,69,279,54,41,69,1477,5,8,4,9,21,7,True,True,2
73691.0,53,1,707,21,250,85,43,73,1179,2,6,2,8,16,2,False,False,2
62859.0,65,1,1063,89,102,16,12,25,1307,4,9,4,6,19,6,True,True,1
46463.0,53,2,163,2,40,8,11,11,235,7,3,1,6,10,6,False,True,1
55282.0,54,1,125,6,73,8,4,19,235,1,3,1,6,10,4,True,True,0
78710.0,47,1,721,0,152,119,50,50,1092,3,7,6,12,25,4,False,True,2
50616.0,74,1,30,2,25,0,1,9,67,1,1,1,4,6,2,False,True,0
49431.0,69,1,219,3,100,26,0,17,365,2,7,1,5,13,8,True,False,1
61278.0,71,1,111,3,28,2,6,15,165,2,3,1,4,8,6,False,False,0
26490.0,66,0,45,47,52,21,20,25,210,2,3,1,5,9,6,False,True,0
46734.0,58,3,100,1,39,6,1,76,223,4,3,2,3,8,6,True,True,1
56253.0,61,1,509,0,65,7,11,5,597,4,7,2,9,18,6,False,False,1
19986.0,39,1,3,6,5,0,2,6,22,1,0,0,3,3,7,False,False,0
25965.0,44,0,2,2,11,41,7,11,74,1,2,0,3,5,8,False,False,0
14661.0,68,0,4,1,11,6,2,2,26,1,1,0,3,4,6,False,True,0
18690.0,65,0,6,1,7,23,4,19,60,1,1,1,2,4,8,False,False,0
45068.0,50,1,14,0,3,0,0,3,20,1,1,0,2,3,7,False,True,0
21063.0,37,1,1,10,11,19,3,15,59,2,2,0,3,5,6,True,False,0
29187.0,56,1,26,0,6,0,0,2,34,1,1,0,3,4,8,False,True,0
54690.0,53,2,111,16,37,7,9,18,198,3,3,1,5,9,3,False,True,0
59304.0,60,1,418,61,428,80,51,10,1048,3,7,8,10,25,5,False,True,2
59247.0,62,2,327,9,122,19,14,83,574,5,5,2,9,16,6,True,True,1
52614.0,49,1,789,0,142,12,9,38,990,2,2,4,8,14,8,True,True,1
26751.0,50,2,1,1,5,0,3,1,11,1,1,0,2,3,8,False,False,0
81300.0,61,1,1004,12,145,32,12,36,1241,3,10,3,5,18,5,False,True,1
70337.0,45,0,187,81,149,25,43,91,576,1,2,2,12,16,1,True,False,2
41039.0,42,0,34,11,137,179,61,45,467,1,8,1,5,14,8,False,True,2
38946.0,69,1,116,6,82,6,6,41,257,2,3,1,6,10,5,False,False,0
65777.0,57,0,565,32,435,28,32,54,1146,1,2,8,6,16,1,False,False,2
66476.0,48,1,372,18,126,47,48,78,689,2,5,2,11,18,4,True,True,2
77845.0,35,0,760,40,480,0,40,26,1346,1,3,5,12,20,1,False,True,2
50611.0,64,1,459,0,24,6,0,4,493,6,4,5,7,16,6,True,True,1
42315.0,66,1,67,15,80,17,11,80,270,3,1,4,4,9,3,False,True,1
13084.0,72,0,2,0,7,3,7,10,29,1,1,0,3,4,6,False,False,0
47570.0,75,2,67,1,20,0,2,31,121,3,2,2,2,6,7,True,True,0
61923.0,63,2,92,4,18,3,3,6,126,1,2,1,4,7,3,False,True,0
34824.0,29,0,4,2,11,2,0,4,23,1,1,0,2,3,6,True,False,0
26518.0,75,2,20,1,28,3,3,2,57,3,2,0,3,5,8,True,True,0
78468.0,64,0,434,22,388,104,22,34,1004,1,10,7,10,27,4,False,False,2
78901.0,51,1,321,11,309,33,26,34,734,3,9,3,5,17,4,True,False,1
71427.0,46,2,212,123,177,15,64,23,614,2,8,2,8,18,4,False,False,2
90247.0,36,0,1184,32,352,21,16,16,1621,1,3,4,7,14,1,True,True,2
41335.0,56,1,112,19,21,16,14,5,187,3,4,1,4,9,7,True,True,0
35682.0,54,1,23,0,8,6,2,18,57,1,1,1,3,5,2,True,True,0
43185.0,73,1,537,6,42,16,6,30,637,2,9,3,6,18,8,True,False,1
35178.0,53,1,23,1,13,2,2,18,59,1,1,1,2,4,7,False,True,0
25252.0,38,1,1,3,4,2,2,6,18,1,1,0,2,3,8,False,False,0
55250.0,59,1,664,58,83,32,0,66,903,4,7,5,10,22,5,True,True,1
33249.0,49,1,6,10,21,19,14,42,112,2,2,1,3,6,6,True,False,0
58398.0,71,0,299,5,201,21,21,49,596,3,5,4,8,17,4,False,False,1
50272.0,42,1,99,13,66,43,8,4,233,3,4,1,5,10,7,False,False,0
25851.0,46,1,9,4,18,7,5,5,48,2,2,0,3,5,7,False,False,0
45160.0,66,2,8,2,5,3,0,3,21,1,1,0,2,3,7,True,False,0
74806.0,59,1,670,9,249,0,28,9,965,2,5,4,5,14,4,False,True,1
18988.0,40,1,6,0,6,2,1,1,16,2,1,0,3,4,7,False,True,0
44794.0,58,1,54,0,7,0,0,4,65,1,2,0,3,5,6,False,False,0
56962.0,59,3,292,3,77,10,3,26,411,7,6,3,5,14,7,False,True,1
35946.0,75,2,8,0,3,0,0,0,11,1,0,0,3,3,5,True,True,0
53593.0,71,2,349,4,78,6,0,43,480,8,7,2,6,15,8,False,True,1
45072.0,76,3,144,2,99,7,2,30,284,5,6,1,4,11,8,True,True,1
89694.0,51,2,1126,28,211,37,28,42,1472,3,4,3,4,11,5,True,False,2
70545.0,72,1,138,39,63,55,18,21,334,1,4,1,7,12,2,False,True,1
17487.0,35,1,0,0,1,7,4,6,18,1,1,0,2,3,7,False,False,0
64108.0,71,1,948,10,86,13,21,21,1099,4,6,9,11,26,5,True,True,1
34941.0,68,2,39,2,25,4,3,24,97,2,3,0,3,6,8,False,True,0
48767.0,74,3,28,1,21,3,0,10,63,3,2,1,3,6,5,True,True,0
38702.0,46,1,13,11,24,13,8,40,109,2,3,0,4,7,6,False,True,0
82224.0,60,0,307,26,360,138,31,40,902,1,6,9,5,20,3,False,False,2
17003.0,49,1,2,5,12,4,8,7,38,3,2,0,4,6,5,False,True,0
33697.0,54,1,4,3,7,0,3,11,28,1,1,0,2,3,7,True,False,0
63564.0,70,0,769,80,252,15,34,65,1215,1,10,10,7,27,6,False,True,2
51518.0,66,1,350,8,66,17,4,4,449,2,3,2,10,15,3,False,True,1
62220.0,52,1,799,12,375,16,12,12,1226,5,7,6,5,18,6,False,True,1
40662.0,45,1,40,2,23,0,4,23,92,2,2,1,3,6,4,False,True,0
38829.0,65,1,76,0,7,0,0,16,99,1,3,2,2,7,5,False,True,0
35523.0,43,1,11,5,22,12,5,11,66,2,3,0,3,6,7,False,True,0
79146.0,57,2,245,16,223,21,43,16,564,2,8,1,8,17,6,True,False,1
78285.0,36,0,647,107,391,175,67,40,1427,1,6,4,10,20,3,False,True,2
31626.0,46,1,39,1,9,2,1,34,86,1,2,1,2,5,7,True,True,0
48726.0,69,1,138,3,38,4,0,59,242,3,3,2,4,9,6,False,False,1
46891.0,59,1,43,12,23,29,15,61,183,1,2,1,4,7,4,False,True,0
62058.0,68,1,301,7,74,10,0,58,450,4,6,1,7,14,6,False,True,1
72063.0,45,1,180,32,348,76,32,90,758,2,5,2,12,19,2,False,False,2
33622.0,52,2,39,1,22,3,4,12,81,3,2,0,4,6,7,False,False,0
41452.0,71,2,13,0,3,0,0,0,16,1,1,0,2,3,7,False,False,0
40760.0,59,1,70,0,17,0,0,6,93,2,2,1,3,6,6,True,True,0
74250.0,66,0,680,11,392,75,0,0,1158,1,2,11,4,17,1,False,True,2
51124.0,69,2,26,1,11,0,1,4,43,2,1,0,3,4,3,True,True,0
36283.0,48,2,6,5,5,8,0,5,29,2,1,0,3,4,4,False,False,0
20587.0,54,1,2,3,6,4,1,9,25,1,1,1,2,4,7,True,False,0
30467.0,52,1,1,3,8,2,5,5,24,1,1,0,2,3,7,False,False,0
31590.0,52,1,6,2,15,6,6,3,38,1,1,0,3,4,8,False,False,0
20425.0,38,1,4,12,5,3,16,17,57,2,2,0,3,5,7,False,False,0
17144.0,64,2,18,2,19,0,2,6,47,5,3,0,4,7,7,False,True,0
82017.0,67,0,184,23,446,30,23,23,729,1,5,4,7,16,2,False,True,2
16813.0,74,0,4,8,11,12,2,13,50,1,2,0,3,5,7,True,False,0
51267.0,46,2,183,2,64,7,2,12,270,4,3,3,5,11,4,False,False,0
46524.0,63,1,31,19,35,26,14,52,177,2,1,1,5,7,3,True,False,0
45183.0,62,0,219,3,60,12,9,12,315,1,4,1,7,12,7,True,True,0
70421.0,70,1,479,28,136,75,14,35,767,3,10,3,7,20,6,False,True,1
19329.0,56,1,24,1,16,12,2,5,60,3,4,0,3,7,8,False,False,0
61872.0,54,1,330,5,159,36,27,16,573,4,4,4,9,17,4,False,True,1
46984.0,68,2,19,1,10,2,1,8,41,1,1,0,3,4,5,True,False,0
34838.0,73,2,28,23,29,29,14,47,170,3,2,1,4,7,6,False,False,0
48192.0,66,0,1039,43,204,153,58,29,1526,3,2,8,12,22,8,False,False,2
49681.0,48,2,411,0,26,0,0,21,458,6,7,1,7,15,7,False,True,1
56850.0,53,1,34,1,19,2,7,0,63,1,1,1,3,5,2,False,True,0
55267.0,67,1,161,28,136,32,3,45,405,4,3,4,6,13,3,False,False,1
26872.0,43,0,3,10,8,3,16,32,72,1,1,1,2,4,6,False,False,0
21359.0,52,1,12,2,17,6,1,10,48,2,2,0,3,5,8,True,False,0
73170.0,49,0,184,174,256,50,30,32,726,1,5,4,6,15,2,True,False,2
52750.0,69,1,393,0,239,90,69,69,860,6,5,7,9,21,4,False,True,2
65968.0,54,1,376,9,83,19,4,4,495,2,5,4,7,16,3,False,True,1
30772.0,48,2,7,2,4,2,1,4,20,1,1,0,2,3,6,False,False,0
65685.0,52,1,642,14,49,0,7,57,769,1,9,2,9,20,5,False,False,1
25804.0,46,1,8,7,9,13,6,12,55,2,2,0,3,5,8,False,True,0
22063.0,52,1,7,10,13,3,11,11,55,2,2,0,3,5,7,False,False,0
57091.0,63,0,464,5,64,7,0,37,577,1,7,3,7,17,5,True,False,1
22419.0,61,0,30,3,47,19,21,42,162,1,3,2,2,7,8,False,False,0
87771.0,65,1,1492,38,287,50,57,33,1957,1,5,10,4,19,6,False,False,2
93404.0,70,3,1279,15,287,20,0,15,1616,3,3,4,7,14,5,False,False,1
37859.0,62,3,22,1,8,2,1,2,36,2,1,0,3,4,8,True,False,0
80995.0,66,1,860,28,409,73,56,56,1482,1,8,9,4,21,4,True,True,2
16529.0,40,1,3,0,5,13,0,1,22,1,1,0,3,4,6,False,False,0
55412.0,48,2,10,5,28,11,1,8,63,1,2,0,3,5,5,True,True,0
56575.0,57,2,421,5,90,0,16,10,542,3,7,3,7,17,5,False,True,1
25130.0,44,1,2,5,7,0,18,18,50,2,2,0,3,5,7,False,True,0
35441.0,57,2,25,1,9,2,1,1,39,2,1,0,3,4,8,False,False,0
49494.0,52,1,191,9,97,0,6,82,385,2,6,1,5,12,7,True,True,1
45889.0,44,1,31,0,6,0,1,8,46,1,1,0,3,4,6,True,True,0
34026.0,74,2,18,6,15,12,8,17,76,3,2,1,3,6,5,False,False,0
40049.0,50,1,91,65,52,10,44,28,290,3,3,2,6,11,5,False,False,1
34176.0,36,1,5,7,24,19,14,20,89,4,3,0,4,7,6,True,False,0
82504.0,64,0,362,50,431,134,35,54,1066,1,3,6,7,16,1,False,True,2
55284.0,68,1,547,7,140,0,7,63,764,3,7,5,8,20,5,True,True,1
49980.0,61,1,104,1,54,13,9,14,195,2,3,1,5,9,5,True,False,0
15072.0,44,2,8,2,15,0,10,18,53,4,3,1,3,7,5,False,False,0
65324.0,70,1,384,0,102,21,32,5,544,3,6,2,9,17,4,False,True,1
30843.0,58,2,24,0,2,0,0,9,35,2,1,1,2,4,5,False,True,0
46374.0,50,1,408,0,21,0,0,17,446,3,7,1,7,15,8,False,True,1
38576.0,51,1,34,0,7,0,0,0,41,1,1,0,3,4,7,False,True,0
55357.0,39,2,374,64,116,84,25,64,727,3,6,2,11,19,5,False,False,2
37758.0,58,2,27,2,10,0,0,1,40,2,1,0,3,4,8,False,False,0
85710.0,35,0,600,20,350,29,30,33,1062,1,6,9,10,25,2,False,True,2
23228.0,55,1,13,2,18,6,1,0,40,2,2,0,3,5,8,False,False,0
44602.0,55,2,167,2,89,0,0,34,292,6,6,1,4,11,8,False,True,1
7500.0,37,0,0,2,3,4,1,5,15,1,0,0,3,3,6,False,False,0
38683.0,35,1,46,35,69,84,41,66,341,6,4,1,6,11,7,False,True,1
49514.0,49,1,88,39,78,58,13,93,369,2,6,1,4,11,7,True,True,1
57906.0,51,1,243,11,119,10,3,15,401,3,4,2,8,14,4,False,True,1
43456.0,58,1,275,11,68,25,7,7,393,3,5,1,8,14,5,True,True,1
19485.0,38,2,6,0,4,0,0,0,10,1,1,0,2,3,7,True,True,0
30545.0,45,1,4,12,15,19,7,12,69,2,2,0,3,5,7,False,False,0
70123.0,41,0,1308,0,396,23,0,0,1727,1,5,7,4,16,3,False,True,2
62450.0,65,1,515,47,267,62,66,38,995,2,5,5,4,14,3,True,False,2
21675.0,48,1,4,0,16,17,4,4,45,3,4,0,3,7,7,False,False,0
42395.0,43,2,48,13,57,24,15,25,182,4,3,1,4,8,7,True,True,0
39922.0,41,1,29,12,59,19,1,36,156,2,3,0,4,7,8,False,False,0
24762.0,52,1,6,10,12,3,15,40,86,3,3,1,2,6,8,True,False,0
35797.0,49,1,27,1,14,4,1,21,68,2,2,0,3,5,8,False,False,0
36627.0,49,2,9,1,5,0,0,1,16,1,0,0,3,3,5,True,False,0
51111.0,43,2,22,0,19,6,5,3,55,2,2,0,3,5,6,False,True,0
42243.0,65,2,48,0,2,0,0,5,55,2,2,0,3,5,7,False,False,0
51195.0,62,2,230,14,156,82,24,58,564,8,9,2,5,16,8,False,False,1
68092.0,46,0,852,60,207,78,36,48,1281,2,2,6,10,18,5,True,True,2
51390.0,59,2,205,20,47,23,2,56,353,6,5,2,5,12,5,True,True,1
26868.0,33,1,0,0,1,8,3,2,14,1,1,0,2,3,7,True,False,0
48948.0,81,0,437,8,206,160,49,42,902,2,7,10,5,22,6,True,True,2
37087.0,50,1,194,55,134,15,0,3,401,3,4,2,8,14,6,False,True,1
21846.0,38,1,7,17,18,6,10,26,84,4,4,0,3,7,8,True,False,0
54137.0,54,1,171,0,11,0,1,20,203,2,4,1,4,9,6,True,False,0
66825.0,57,0,243,101,405,29,40,40,858,1,4,5,6,15,2,False,False,2
57100.0,51,0,181,21,69,39,3,96,409,1,3,3,6,12,3,False,False,1
58917.0,55,3,151,7,89,0,7,28,282,5,4,1,6,11,5,False,False,1
45684.0,53,1,5,1,5,10,0,7,28,1,1,0,2,3,7,True,False,0
47889.0,50,1,29,0,29,0,5,4,67,1,2,0,3,5,5,False,False,0
45921.0,38,0,102,9,49,24,3,12,199,1,2,1,6,9,4,False,True,0
35641.0,52,1,63,3,67,8,9,28,178,2,3,1,4,8,7,False,True,0
62820.0,70,0,398,61,265,138,61,53,976,1,3,4,6,13,1,False,False,2
73113.0,64,0,741,19,154,50,9,28,1001,1,3,4,7,14,2,False,True,2
84169.0,42,0,1478,19,403,0,19,0,1919,1,7,6,6,19,3,False,True,2
42607.0,70,1,156,29,56,30,32,47,350,2,3,2,7,12,3,True,True,1
74637.0,70,0,960,64,464,146,0,16,1650,1,6,9,9,24,3,True,True,2
46015.0,69,2,38,0,2,0,0,6,46,1,1,0,3,4,7,False,True,0
39858.0,55,1,15,20,25,2,7,26,95,1,2,0,4,6,6,True,True,0
34469.0,76,2,19,6,20,0,5,12,62,3,1,1,4,6,4,False,True,0
68397.0,48,1,760,80,466,17,13,80,1416,1,6,9,5,20,3,False,True,2
46107.0,35,1,31,9,27,16,9,33,125,1,1,1,4,6,3,True,False,0
64950.0,73,1,819,0,72,12,0,63,966,2,11,2,10,23,7,True,True,1
25443.0,35,1,1,4,3,8,9,7,32,1,1,0,3,4,8,False,False,0
32892.0,53,1,26,0,15,2,1,2,46,2,3,0,3,6,8,False,True,0
60554.0,49,1,588,7,76,110,15,15,811,2,8,4,9,21,6,True,True,1
14906.0,38,0,7,7,14,7,16,15,66,3,2,1,3,6,7,True,False,0
51563.0,37,0,1166,0,48,0,0,36,1250,1,4,4,10,18,8,False,True,1
68274.0,45,2,135,25,51,23,25,46,305,2,4,2,5,11,3,True,False,1
39771.0,47,1,6,2,18,2,8,14,50,1,2,0,3,5,4,False,False,0
67893.0,49,1,711,28,142,49,18,47,995,2,3,2,9,14,8,True,True,1
27922.0,45,1,11,0,13,2,4,11,41,1,2,0,3,5,4,False,True,0
52190.0,48,2,42,0,17,0,0,18,77,3,2,1,3,6,5,False,True,0
44051.0,51,2,79,7,58,6,3,18,171,4,3,1,4,8,6,True,True,0
42767.0,53,2,20,6,43,19,5,38,131,1,3,1,2,6,8,True,True,0
46106.0,48,2,30,0,8,2,0,14,54,1,1,1,2,4,6,False,True,0
16927.0,48,2,20,2,23,3,1,4,53,5,3,0,4,7,8,False,True,0
53700.0,72,1,263,5,233,69,41,83,694,4,5,5,8,18,5,True,False,2
59041.0,51,2,69,2,15,2,2,6,96,2,2,0,4,6,5,False,False,0
54237.0,67,1,267,3,30,4,0,57,361,4,5,2,5,12,6,True,True,1
52597.0,62,1,492,0,37,7,0,42,578,3,6,3,8,17,5,True,True,1
41021.0,55,1,14,7,9,6,16,12,64,2,2,0,3,5,6,False,True,0
40233.0,49,1,80,4,46,0,17,2,149,5,2,1,5,8,6,False,True,0
50183.0,44,2,97,12,84,13,10,15,231,7,3,1,6,10,5,False,False,1
33471.0,51,1,43,2,27,0,9,12,93,3,3,0,4,7,7,False,False,0
34596.0,50,1,14,0,2,0,0,7,23,1,1,0,2,3,8,False,True,0
40706.0,56,3,59,0,11,4,2,5,81,4,3,0,4,7,7,False,True,0
15716.0,36,1,16,5,30,8,7,26,92,3,3,0,4,7,8,False,True,0
59052.0,65,1,230,35,75,63,57,31,491,3,7,1,7,15,5,True,True,1
83715.0,62,0,318,8,407,150,35,8,926,1,2,8,13,23,0,False,False,2
82576.0,65,0,1206,55,445,168,18,18,1910,1,2,4,12,18,1,False,True,2
56962.0,59,3,292,3,77,10,3,26,411,7,6,3,5,14,7,False,True,1
35704.0,72,2,30,9,12,2,11,30,94,3,2,0,4,6,4,False,False,0
46779.0,64,2,12,1,3,0,0,7,23,1,0,1,2,3,4,True,True,0
33462.0,45,1,22,3,18,0,0,11,54,1,2,0,3,5,7,True,True,0
65352.0,50,1,284,3,84,4,7,23,405,2,4,2,8,14,4,False,True,1
35340.0,68,2,27,0,12,0,1,5,45,2,2,0,3,5,5,True,True,0
85683.0,70,0,1296,17,311,45,69,51,1789,1,2,4,10,16,1,True,False,2
24884.0,52,1,3,6,7,0,0,3,19,1,0,0,3,3,7,False,True,0
64449.0,35,1,218,63,282,137,35,70,805,4,5,3,12,20,4,True,False,2
64587.0,70,2,66,0,16,0,6,20,108,2,1,1,4,6,3,True,False,0
34824.0,29,0,4,2,11,2,0,4,23,1,1,0,2,3,6,True,False,0
26091.0,67,2,15,10,19,8,17,20,89,3,2,1,3,6,5,False,False,0
52845.0,51,1,384,25,292,130,41,64,936,3,8,8,6,22,6,False,False,2
46086.0,68,1,244,8,32,7,2,50,343,4,3,1,8,12,4,True,False,1
78028.0,68,1,158,19,288,25,0,38,528,1,6,4,9,19,7,True,True,1
95169.0,37,0,1285,21,449,106,20,20,1901,1,4,3,4,11,1,True,True,2
22434.0,37,1,4,12,11,3,13,15,58,2,2,0,3,5,8,False,False,0
36930.0,70,1,223,2,31,0,2,39,297,5,5,2,4,11,8,False,True,1
36130.0,70,1,157,43,127,68,56,37,488,6,3,8,4,15,4,True,False,2
65569.0,71,1,397,46,288,20,38,70,859,2,6,5,10,21,3,False,True,2
19514.0,56,2,14,3,21,2,1,28,69,4,3,1,2,6,8,False,False,0
36736.0,61,2,10,0,3,0,0,4,17,1,1,0,2,3,6,True,True,0
49187.0,48,1,81,1,31,2,1,0,116,1,1,1,5,7,2,False,True,0
34053.0,56,1,63,0,21,7,0,12,103,1,3,0,3,6,8,False,True,0
38196.0,53,2,30,0,11,0,0,3,44,3,2,0,4,6,5,False,True,0
59412.0,73,0,90,67,165,30,43,11,406,1,4,2,8,14,3,False,True,2
54165.0,55,0,127,4,73,15,6,11,236,1,2,1,7,10,2,False,False,0
32300.0,51,1,13,3,6,6,5,6,39,1,1,0,3,4,8,False,False,0
20180.0,48,0,18,42,24,15,20,18,137,1,2,1,4,7,7,True,False,0
34961.0,51,1,45,2,26,4,1,1,79,3,3,1,3,7,7,False,False,0
28440.0,50,1,38,1,24,0,0,0,63,1,2,0,3,5,8,False,True,0
33564.0,58,1,61,0,3,0,0,7,71,1,1,1,3,5,5,False,True,0
17345.0,46,1,4,9,16,17,0,12,58,2,2,1,2,5,8,False,False,0
28647.0,46,1,19,8,29,0,12,26,94,1,2,2,2,6,7,True,False,0
32173.0,66,1,18,0,2,0,0,2,22,1,1,0,3,4,4,True,True,0
68316.0,60,1,806,80,161,120,11,33,1211,5,10,7,10,27,6,False,True,2
68695.0,55,0,458,81,356,106,50,40,1091,1,4,4,7,15,2,False,False,2
31056.0,47,1,5,10,13,3,8,16,55,1,1,0,3,4,8,False,True,0
28071.0,44,0,39,33,130,41,26,44,313,2,5,1,5,11,8,True,False,0
37334.0,66,2,26,1,16,2,2,15,62,4,3,0,4,7,4,False,True,0
46423.0,52,2,68,0,16,0,0,8,92,3,2,0,4,6,7,True,True,0
37126.0,53,1,45,3,9,4,4,7,72,1,1,2,2,5,6,False,True,0
38998.0,70,2,34,1,14,0,0,5,54,3,2,0,3,5,8,False,False,0
34728.0,38,1,14,0,16,0,0,6,36,1,1,1,2,4,6,False,False,0
33168.0,59,1,80,1,37,0,1,3,122,3,2,1,4,7,7,True,True,0
33585.0,58,1,30,11,33,13,6,29,122,1,2,0,4,6,4,False,True,0
77037.0,64,1,463,96,333,168,53,10,1123,1,7,7,12,26,3,False,True,2
44529.0,58,1,538,13,91,17,6,26,691,6,6,2,11,19,5,False,False,1
28764.0,58,2,8,0,3,0,0,1,12,1,1,0,2,3,8,False,True,0
25959.0,54,2,4,2,12,7,5,26,56,2,1,2,2,5,6,True,True,0
27100.0,41,1,12,0,13,2,0,10,37,1,1,0,3,4,7,False,True,0
42557.0,50,1,192,5,53,0,5,15,270,4,6,1,4,11,8,False,False,1
53312.0,73,0,241,0,12,0,0,25,278,1,5,1,5,11,7,False,True,1
72228.0,72,0,631,28,491,30,14,56,1250,1,6,7,8,21,3,True,False,2
67605.0,37,0,336,28,282,184,54,54,938,1,2,8,6,16,1,False,False,2
62845.0,75,2,1099,0,45,0,0,34,1178,11,3,4,10,17,8,False,True,1
42000.0,37,0,124,83,267,85,59,35,653,2,5,2,11,18,5,True,True,2
35860.0,51,2,15,0,8,4,2,20,49,2,1,1,2,4,5,True,True,0
65526.0,60,1,397,19,69,12,0,9,506,1,4,4,8,16,2,False,True,1
16860.0,63,2,10,4,4,3,3,14,38,3,1,1,3,5,7,False,False,0
22304.0,68,0,3,2,7,0,4,2,18,1,1,0,2,3,8,True,False,0
67023.0,46,0,444,44,382,11,8,17,906,1,3,7,13,23,2,False,False,2
32892.0,53,1,26,0,15,2,1,2,46,2,3,0,3,6,8,False,True,0
59925.0,69,1,473,21,176,19,21,56,766,3,9,2,9,20,6,False,False,1
39722.0,71,1,32,0,5,2,0,8,47,2,2,0,3,5,5,False,False,0
87171.0,43,0,1001,44,107,58,44,44,1298,1,6,7,11,24,2,False,True,2
26907.0,48,2,9,1,7,0,3,2,22,2,1,0,3,4,7,False,True,0
50014.0,56,1,234,14,77,19,10,42,396,2,4,1,8,13,5,True,True,1
41014.0,46,1,7,2,6,2,0,3,20,1,1,0,2,3,7,False,True,0
40479.0,42,1,5,0,8,2,0,0,15,1,0,0,3,3,4,False,False,0
24163.0,54,2,4,1,7,2,1,2,17,2,1,0,3,4,4,True,False,0
84460.0,66,0,152,27,103,106,54,81,523,0,9,9,4,22,5,False,True,2
43776.0,41,1,8,0,9,2,1,3,23,1,1,0,2,3,6,False,False,0
71691.0,66,0,336,130,411,240,32,43,1192,1,4,7,5,16,2,True,True,2
39190.0,50,1,68,8,18,19,8,12,133,2,2,1,4,7,5,True,True,0
71367.0,65,0,227,23,389,42,21,75,777,1,4,5,7,16,2,False,False,2
38578.0,52,2,38,4,22,3,3,3,73,3,3,0,3,6,8,True,True,0
57236.0,59,2,105,0,9,2,1,4,121,3,2,1,4,7,3,False,True,0
61825.0,45,1,162,50,100,55,30,27,424,1,4,2,8,14,4,True,False,2
79803.0,66,1,574,8,216,21,16,33,868,1,4,3,5,12,1,True,False,2
80910.0,38,0,160,80,369,67,39,41,756,1,3,3,8,14,1,True,True,2
27590.0,42,1,6,0,5,0,0,1,12,1,1,0,2,3,7,False,True,0
56775.0,45,1,614,35,160,58,35,35,937,2,5,8,10,23,5,False,False,2
54210.0,45,1,70,54,109,80,9,45,367,2,4,1,7,12,5,False,True,1
38508.0,38,1,120,19,206,25,19,54,443,6,7,2,5,14,8,False,False,1
53187.0,54,1,211,2,30,7,7,10,267,2,4,1,6,11,5,False,False,0
30023.0,52,1,11,0,16,7,6,21,61,1,2,0,3,5,8,False,False,0
50870.0,72,1,53,0,8,0,0,2,63,1,2,0,3,5,5,False,True,0
15315.0,54,0,7,4,13,15,8,17,64,2,2,0,4,6,5,False,True,0
65463.0,50,1,391,32,70,21,32,16,562,2,6,2,9,17,5,False,True,1
66480.0,59,2,199,9,57,20,21,6,312,7,4,1,7,12,4,False,False,1
76773.0,70,0,516,56,449,86,33,16,1156,1,2,2,11,15,1,True,False,2
54466.0,51,2,12,0,4,0,0,0,16,1,1,0,2,3,5,True,True,0
16269.0,40,1,19,3,18,3,1,0,44,3,3,0,3,6,8,True,True,0
33569.0,41,1,16,2,18,3,0,24,63,1,1,1,2,4,8,False,True,0
22634.0,58,0,2,23,11,8,6,46,96,1,2,1,2,5,8,False,False,0
70566.0,56,1,381,28,215,84,28,21,757,2,6,5,9,20,3,True,False,2
31605.0,45,1,74,0,42,2,1,6,125,2,2,1,4,7,7,False,True,0
52034.0,51,2,146,0,93,7,13,73,332,5,4,2,5,11,7,True,True,1
48526.0,45,1,23,17,23,43,20,9,135,1,2,1,4,7,3,True,False,0
46734.0,70,1,110,5,137,26,23,29,330,2,6,1,5,12,7,False,False,1
39552.0,62,2,165,3,147,4,24,41,384,7,6,2,5,13,8,True,False,1
86358.0,58,2,957,47,494,82,47,95,1722,4,5,3,6,14,8,True,False,2
46931.0,47,3,41,0,17,3,1,16,78,2,1,1,3,5,3,False,False,0
16581.0,39,0,1,3,4,2,3,11,24,1,0,0,3,3,4,True,False,0
67381.0,73,1,815,8,53,11,0,70,957,4,2,2,9,13,7,False,True,1
25930.0,57,2,6,1,2,2,0,4,15,1,1,0,2,3,7,True,False,0
42693.0,46,1,8,4,20,6,3,16,57,1,1,0,3,4,5,False,False,0
49669.0,50,1,166,5,107,11,8,29,326,2,5,1,6,12,6,False,True,1
85696.0,62,0,714,76,395,116,0,12,1313,1,4,6,9,19,1,True,True,2
10979.0,35,0,8,4,10,2,2,4,30,2,3,0,3,6,5,True,True,0
49678.0,63,1,229,5,56,3,2,20,315,2,6,2,4,12,7,False,False,1
37155.0,35,1,23,0,26,7,15,3,74,1,2,0,4,6,5,False,False,0
21282.0,46,1,1,5,8,4,8,20,46,2,2,1,2,5,6,True,True,0
33419.0,62,1,56,0,12,0,0,18,86,2,2,0,4,6,7,True,True,0
21255.0,50,1,29,0,25,2,2,3,61,4,2,1,4,7,4,False,True,0
42162.0,43,1,46,7,59,2,4,27,145,2,3,1,3,7,6,False,False,0
54450.0,68,2,454,0,171,8,19,32,684,12,9,2,8,19,8,False,False,1
57744.0,70,1,350,3,39,0,0,19,411,2,9,1,4,14,8,False,True,1
57513.0,81,0,735,40,183,52,20,30,1060,2,9,3,13,25,6,True,True,2
7500.0,45,1,5,2,3,3,0,5,18,1,1,0,2,3,8,False,False,0
54197.0,64,1,162,6,37,6,13,13,237,2,1,3,6,10,1,False,True,0
23091.0,61,2,35,0,11,0,0,2,48,4,2,1,3,6,7,True,True,0
46049.0,48,2,342,9,112,19,14,19,515,10,5,2,9,16,7,False,False,1
79410.0,63,0,658,80,483,123,13,13,1370,1,3,2,5,10,1,False,False,2
44375.0,59,1,213,5,28,7,7,41,301,1,4,1,6,11,5,False,False,0
54450.0,68,2,454,0,171,8,19,32,684,12,9,2,8,19,8,False,False,1
59594.0,59,1,457,4,29,0,0,9,499,1,8,1,7,16,7,False,False,1
40344.0,50,1,210,0,6,0,0,2,218,2,4,1,5,10,7,False,True,0
62710.0,52,1,441,35,83,7,29,11,606,4,4,2,12,18,4,False,False,1
48985.0,56,1,19,13,18,10,7,8,75,1,1,1,3,5,3,False,True,0
35322.0,56,3,28,9,37,12,7,13,106,3,2,0,4,6,8,False,False,0
81657.0,55,0,364,40,425,158,60,50,1097,1,3,4,8,15,1,True,False,2
14421.0,28,0,0,0,2,3,3,8,16,1,1,0,2,3,5,False,False,0
20130.0,50,0,0,6,3,7,6,12,34,1,1,0,3,4,8,False,True,0
66726.0,67,2,349,7,35,0,0,47,438,3,8,2,4,14,7,False,True,1
23724.0,45,1,5,23,15,0,18,14,75,2,2,0,3,5,8,False,False,0
47353.0,64,1,184,2,19,8,8,4,225,3,2,2,6,10,5,False,True,0
33444.0,72,2,8,0,8,0,0,2,18,1,1,0,2,3,8,False,True,0
54386.0,43,1,277,21,64,62,21,25,470,2,3,2,10,15,3,False,False,1
28510.0,43,2,44,5,19,0,4,19,91,3,2,0,4,6,5,True,False,0
48070.0,74,1,373,14,83,6,9,19,504,3,8,2,6,16,7,False,False,1
43140.0,67,1,134,8,76,6,0,11,235,1,4,1,5,10,6,False,False,0
54959.0,63,1,1148,0,60,0,0,24,1232,3,9,5,4,18,7,True,True,1
15056.0,66,2,6,12,3,21,6,40,88,5,2,2,3,7,5,True,False,0
26954.0,53,1,4,1,11,0,0,1,17,1,1,0,2,3,7,True,False,0
22327.0,39,1,5,4,8,2,0,5,24,1,1,0,3,4,5,True,False,0
44393.0,59,2,24,2,20,2,2,10,60,2,1,0,4,5,4,False,False,0
62000.0,72,1,899,0,101,0,0,20,1020,1,6,6,13,25,4,True,True,1
31497.0,62,1,108,1,28,13,1,4,155,2,3,1,4,8,8,False,True,0
45894.0,50,2,27,2,7,0,2,13,51,1,1,0,3,4,5,False,True,0
67369.0,55,1,1298,0,70,37,14,42,1461,4,7,4,10,21,4,True,True,1
58401.0,64,1,10,0,11,17,29,29,96,1,1,2,2,5,4,True,False,0
62307.0,72,1,87,13,34,10,6,10,160,1,4,0,4,8,5,True,False,0
43641.0,55,2,57,2,51,4,2,23,139,3,2,1,4,7,6,False,True,0
46891.0,59,1,43,12,23,29,15,61,183,1,2,1,4,7,4,False,True,0
70091.0,55,1,964,34,137,15,0,11,1161,2,5,2,10,17,8,False,True,1
78075.0,52,0,572,8,259,34,35,80,988,1,3,5,5,13,1,False,True,2
54809.0,47,2,63,6,57,13,13,22,174,4,2,1,5,8,4,False,False,0
51412.0,66,1,140,3,29,4,5,14,195,2,3,2,4,9,4,False,True,0
15287.0,45,1,1,2,8,4,3,13,31,2,1,1,2,4,7,True,False,0
50965.0,68,1,544,13,85,8,6,29,685,3,10,4,5,19,8,False,True,1
18351.0,34,0,1,12,9,0,14,7,43,1,2,0,3,5,7,False,False,0
40451.0,67,2,35,0,4,0,0,10,49,1,1,1,2,4,5,False,True,0
36317.0,59,1,87,3,25,3,2,13,133,2,3,0,4,7,7,False,False,0
42213.0,67,1,309,3,24,4,3,20,363,2,5,1,7,13,7,False,False,1
77044.0,52,1,625,38,242,50,34,76,1065,2,7,11,11,29,4,False,False,2
56721.0,52,2,157,6,39,6,13,75,296,5,4,1,5,10,6,False,False,1
42160.0,49,2,48,9,45,3,15,20,140,4,2,1,4,7,6,True,False,0
61559.0,59,1,279,83,88,32,14,34,530,1,4,2,10,16,3,True,False,2
34377.0,61,1,62,0,22,3,1,26,114,2,2,2,2,6,7,True,False,0
8940.0,38,1,1,45,3,4,6,42,101,3,3,1,3,7,8,True,False,0
26228.0,51,1,2,6,4,3,1,9,25,1,1,0,2,3,8,False,False,0
40211.0,43,2,51,1,7,2,1,25,87,2,2,1,2,5,8,False,False,0
33438.0,66,2,62,1,16,3,2,6,90,4,2,1,4,7,5,True,True,0
75032.0,65,1,952,12,180,47,12,12,1215,2,5,4,9,18,3,False,True,2
61284.0,69,0,618,15,106,20,7,45,811,1,11,2,8,21,6,True,True,1
22518.0,38,1,11,7,12,2,2,27,61,2,2,1,2,5,5,False,False,0
54730.0,49,1,318,3,17,4,7,56,405,5,4,1,8,13,4,False,True,1
38452.0,69,2,56,0,14,0,0,2,72,3,3,0,3,6,7,False,True,0
44421.0,53,2,110,5,59,7,1,7,189,5,5,0,4,9,8,True,False,0
38197.0,38,1,23,0,11,2,1,3,40,1,1,0,3,4,5,False,True,0
41986.0,46,1,27,5,8,8,3,12,63,3,3,0,4,7,4,True,False,0
28427.0,41,1,18,3,19,3,3,6,52,2,2,0,3,5,8,False,False,0
37395.0,48,1,18,0,9,0,1,11,39,1,1,0,3,4,6,False,True,0
55249.0,68,1,97,1,19,2,0,11,130,1,2,1,4,7,3,False,True,0
84906.0,52,0,997,15,414,99,30,76,1631,1,5,6,12,23,2,False,False,2
28691.0,35,1,5,4,13,8,0,4,34,1,1,0,3,4,8,False,False,0
44213.0,72,2,95,11,35,0,4,7,152,4,2,1,5,8,6,True,False,0
25707.0,40,1,1,6,2,3,6,3,21,1,1,0,3,4,7,True,False,0
59062.0,57,3,46,1,12,3,0,9,71,2,2,0,3,5,4,False,True,0
66000.0,77,0,244,51,270,101,0,45,711,1,1,3,5,9,1,False,True,2
27683.0,46,1,152,9,121,12,12,45,351,4,6,2,4,12,8,False,True,1
40521.0,56,2,12,0,5,0,0,4,21,1,0,1,2,3,5,False,False,0
20427.0,51,1,5,0,4,0,0,1,10,1,1,0,2,3,8,False,True,0
65106.0,49,1,790,19,133,12,0,19,973,3,8,3,13,24,6,False,False,1
67433.0,72,2,615,28,259,12,48,30,992,4,6,5,13,24,4,False,False,2
77766.0,57,1,1004,59,265,115,59,27,1529,2,11,10,11,32,6,False,True,2
55158.0,54,2,293,0,87,4,11,23,418,4,7,2,5,14,7,False,True,1
39356.0,48,2,15,0,2,0,0,6,23,1,1,0,2,3,6,False,False,0
35860.0,51,2,15,0,8,4,2,20,49,2,1,1,2,4,5,True,True,0
73450.0,42,0,1142,51,415,90,69,37,1804,1,7,8,11,26,3,False,True,2
31454.0,64,2,28,0,11,0,0,9,48,3,2,0,3,5,8,False,False,0
47139.0,72,2,46,0,12,0,2,23,83,2,2,1,2,5,7,True,False,0
19656.0,54,1,25,4,9,6,8,32,84,3,2,1,3,6,7,False,False,0
45579.0,76,1,145,1,33,2,1,1,183,1,4,1,4,9,6,False,True,0
55956.0,80,0,760,38,104,50,9,38,999,2,7,3,4,14,4,False,False,1
64191.0,61,1,420,15,186,151,38,15,825,3,5,3,13,21,3,True,True,2
38808.0,52,1,125,17,52,3,19,30,246,4,5,1,4,10,8,True,False,1
57183.0,58,2,464,5,64,7,0,70,610,8,9,1,7,17,8,False,True,1
23748.0,56,1,6,6,29,12,15,8,76,3,2,1,3,6,8,True,True,0
66303.0,53,1,1090,12,96,16,12,60,1286,4,3,4,11,18,8,False,False,1
37368.0,49,1,3,2,11,2,2,10,30,1,1,0,2,3,6,False,True,0
40800.0,60,3,24,0,27,8,30,10,99,2,3,0,3,6,7,False,False,0
46149.0,49,1,254,6,71,4,0,27,362,5,5,1,7,13,5,False,False,1
39767.0,73,0,113,61,204,34,26,47,485,2,7,1,7,15,8,False,True,1
33986.0,54,1,16,2,18,2,1,5,44,1,1,0,3,4,7,True,False,0
57091.0,52,1,462,0,24,6,0,4,496,2,9,2,5,16,7,False,True,1
46831.0,55,2,22,2,10,6,4,34,78,2,1,2,2,5,4,False,True,0
15759.0,68,0,1,2,5,6,0,3,17,1,1,0,2,3,7,False,False,0
43050.0,51,1,30,5,24,6,3,8,76,2,2,0,4,6,5,False,True,0
42997.0,47,2,4,0,5,0,1,5,15,1,1,0,2,3,7,True,True,0
48918.0,61,2,52,0,9,0,0,1,62,2,1,0,4,5,4,True,True,0
60033.0,70,1,62,1,57,19,11,48,198,2,2,1,5,8,2,False,True,1
57811.0,58,1,545,7,114,37,21,78,802,5,7,2,11,20,5,False,False,1
7500.0,46,2,6,5,4,13,4,25,57,4,2,1,3,6,6,True,False,0
23148.0,39,0,4,6,8,6,3,10,37,1,2,0,3,5,7,False,True,0
60894.0,58,1,606,7,155,10,0,54,832,5,10,3,8,21,7,False,False,1
50200.0,48,2,266,6,51,8,6,64,401,6,7,1,5,13,8,False,False,1
81051.0,59,0,1142,29,249,38,29,14,1501,1,5,5,12,22,2,False,True,2
65169.0,42,0,1074,0,69,0,0,46,1189,1,10,4,13,27,6,False,False,1
65695.0,64,1,371,32,189,0,58,6,656,2,5,4,10,19,4,False,True,2
45143.0,59,1,202,5,74,11,5,14,311,3,6,1,5,12,7,False,True,1
59060.0,35,1,35,40,111,36,40,12,274,3,3,1,7,11,4,False,True,1
47009.0,59,1,171,45,73,59,10,90,448,4,3,2,8,13,4,False,False,1
46094.0,51,2,12,2,20,3,2,5,44,1,1,0,3,4,7,False,True,0
40321.0,52,2,44,4,21,6,0,27,102,2,3,0,3,6,7,False,False,0
37235.0,40,1,20,2,9,4,6,20,61,1,1,1,2,4,4,False,False,0
46692.0,66,1,170,6,97,24,12,88,397,3,6,1,5,12,6,False,True,1
18393.0,50,1,7,10,13,16,0,4,50,2,3,0,3,6,8,False,False,0
24711.0,42,0,10,7,25,6,3,7,58,1,3,0,3,6,7,False,False,0
45503.0,49,1,97,4,44,6,1,18,170,1,3,1,4,8,5,False,True,0
27244.0,45,1,6,5,17,3,24,46,101,2,2,2,2,6,7,False,False,0
51948.0,49,1,82,33,54,71,30,41,311,2,5,2,4,11,5,False,False,1
35876.0,41,0,66,2,40,4,3,14,129,1,3,1,3,7,6,False,True,0
40049.0,72,1,13,6,7,0,3,3,32,1,1,0,3,4,6,True,False,0
50127.0,62,1,274,0,21,4,6,15,320,1,5,1,6,12,6,False,False,0
62845.0,75,2,1099,0,45,0,0,34,1178,11,3,4,10,17,8,False,True,1
18929.0,34,0,32,0,8,23,4,18,85,1,1,0,4,5,6,False,False,0
33249.0,49,1,6,10,21,19,14,42,112,2,2,1,3,6,6,True,False,0
26887.0,65,1,6,7,4,3,4,6,30,1,1,0,3,4,6,False,True,0
50150.0,41,0,135,46,92,65,61,11,410,2,5,2,7,14,5,False,True,2
62061.0,48,1,641,7,84,0,30,38,800,3,10,4,7,21,6,False,False,1
85696.0,62,0,714,76,395,116,0,12,1313,1,4,6,9,19,1,True,True,2
18227.0,37,1,1,2,7,4,3,11,28,1,0,1,2,3,8,False,False,0
69139.0,59,1,86,12,75,33,15,6,227,1,4,1,5,10,4,False,False,0
69109.0,42,0,823,25,459,124,29,95,1555,1,6,6,7,19,4,False,False,2
69627.0,62,1,231,161,215,171,30,53,861,2,8,2,11,21,5,True,False,2
38136.0,46,1,8,15,27,0,20,33,103,2,3,1,2,6,8,False,False,0
33316.0,53,2,79,1,31,4,4,12,131,3,2,1,4,7,6,True,True,0
58554.0,56,2,368,24,68,38,0,88,586,6,8,2,6,16,7,False,False,1
17256.0,32,1,6,4,14,8,8,22,62,2,2,1,2,5,8,False,False,0
53034.0,50,2,160,15,196,15,11,50,447,8,6,1,7,14,8,True,False,1
59601.0,47,1,691,7,69,0,7,23,797,4,2,2,7,11,8,True,True,1
47025.0,48,1,254,7,108,20,0,26,415,3,6,3,5,14,6,True,False,1
37971.0,51,1,5,4,10,2,2,7,30,1,1,0,3,4,8,False,False,0
41335.0,56,1,112,19,21,16,14,5,187,3,4,1,4,9,7,True,True,0
67267.0,66,1,134,11,59,15,2,30,251,1,3,2,5,10,2,False,False,1
57338.0,49,1,143,6,52,11,8,17,237,2,4,1,5,10,5,True,False,0
50523.0,64,2,51,4,24,4,7,1,91,2,2,0,4,6,6,False,True,0
35791.0,59,3,27,0,5,0,0,3,35,2,1,0,3,4,8,True,True,0
50611.0,64,1,459,0,24,6,0,4,493,6,4,5,7,16,6,True,True,1
56242.0,55,1,689,8,167,11,8,88,971,5,8,4,11,23,6,False,True,1
48904.0,64,1,283,10,38,0,13,27,371,4,7,2,4,13,8,True,False,1
56243.0,49,3,347,0,35,4,3,7,396,6,4,2,8,14,5,True,False,1
21355.0,39,1,5,13,14,0,5,31,68,2,2,1,2,5,6,False,False,0
57420.0,53,1,280,0,18,0,0,24,322,3,5,1,6,12,7,False,True,1
50943.0,54,1,187,5,65,26,20,14,317,2,4,2,6,12,5,False,True,1
46390.0,69,1,95,14,64,2,9,38,222,1,4,2,3,9,7,True,True,0
54342.0,68,2,84,10,34,11,10,28,177,4,3,1,4,8,6,False,True,1
52028.5,66,2,19,4,12,2,2,6,45,1,1,0,3,4,5,False,False,0
46805.0,60,2,5,1,9,2,0,4,21,1,1,0,2,3,7,True,True,0
55212.0,52,1,25,1,13,0,0,3,42,1,1,0,3,4,7,False,True,0
26907.0,48,2,9,1,7,0,3,2,22,2,1,0,3,4,7,False,True,0
44964.0,44,2,19,1,17,2,0,2,41,1,1,0,3,4,8,False,False,0
53761.0,52,2,158,0,76,13,7,71,325,6,4,4,3,11,5,False,True,1
22682.0,51,1,10,14,29,4,2,36,95,3,2,1,4,7,4,False,False,0
38887.0,52,1,25,1,13,0,0,3,42,1,1,0,3,4,7,False,True,0
41658.0,49,2,8,4,12,15,4,29,72,2,1,1,2,4,4,True,True,0
29791.0,52,1,14,0,6,0,0,0,20,2,2,0,3,5,5,False,True,0
63915.0,68,2,622,7,115,30,0,15,789,2,6,3,12,21,5,False,True,1
39996.0,50,2,11,0,3,0,0,1,15,1,1,0,2,3,6,True,False,0
26759.0,52,1,25,3,16,8,5,2,59,2,2,1,3,6,6,True,False,0
60544.0,63,2,201,2,43,3,5,35,289,4,5,1,5,11,6,False,False,1
65685.0,52,1,642,14,49,0,7,57,769,1,9,2,9,20,5,False,False,1
37716.0,71,1,97,1,41,6,2,41,188,2,4,1,3,8,7,False,False,0
36864.0,67,1,204,5,39,17,0,89,354,3,5,2,4,11,8,True,False,1
44511.0,54,1,513,7,133,46,14,14,727,6,8,4,8,20,8,False,True,1
47352.0,73,1,172,12,112,8,0,15,319,4,6,1,5,12,7,False,True,1
67087.0,71,1,329,35,222,130,35,43,794,2,7,5,8,20,4,False,True,2
57045.0,74,1,296,13,104,11,13,17,454,3,4,2,9,15,3,False,False,1
69389.0,47,1,422,7,238,69,46,15,797,1,7,2,12,21,4,False,True,2
80134.0,52,1,1218,16,272,104,0,80,1690,2,5,3,6,14,6,False,False,2
43142.0,55,2,5,1,7,2,1,4,20,1,1,0,2,3,7,False,True,0
22634.0,58,0,2,23,11,8,6,46,96,1,2,1,2,5,8,False,False,0
51315.0,76,0,68,28,39,16,30,41,222,1,2,2,5,9,2,False,False,1
36026.0,52,3,20,4,10,6,4,17,61,2,2,0,3,5,6,False,False,0
24639.0,51,2,20,3,16,0,4,1,44,3,2,0,4,6,6,False,False,0
34578.0,52,3,7,0,1,0,0,0,8,1,1,0,2,3,6,False,True,0
54132.0,55,1,30,1,8,0,0,3,42,1,1,0,3,4,7,False,True,0
18690.0,65,0,6,1,7,23,4,19,60,1,1,1,2,4,8,False,False,0
28164.0,54,1,3,18,26,11,8,12,78,3,2,0,4,6,7,False,False,0
34596.0,50,1,14,0,2,0,0,7,23,1,1,0,2,3,8,False,True,0
43269.0,52,1,10,1,7,0,0,1,19,1,1,0,2,3,8,False,True,0
38741.0,66,2,7,10,17,8,6,13,61,2,2,0,3,5,7,True,True,0
31907.0,52,0,33,87,64,175,16,74,449,1,6,1,6,13,7,True,False,2
27100.0,41,1,12,0,13,2,0,10,37,1,1,0,3,4,7,False,True,0
31163.0,51,1,2,3,10,11,2,10,38,1,1,0,3,4,6,True,True,0
34853.0,51,2,9,3,15,2,3,2,34,2,2,0,3,5,6,True,False,0
70844.0,57,2,129,26,67,3,67,2,294,5,6,1,5,12,7,True,False,1
31086.0,45,2,16,2,11,3,0,16,48,2,1,1,2,4,8,False,True,0
60544.0,63,2,201,2,43,3,5,35,289,4,5,1,5,11,6,False,False,1
20491.0,38,0,5,4,5,4,2,10,30,1,0,1,2,3,7,False,True,0
42523.0,60,0,14,36,11,3,26,35,125,1,1,1,4,6,2,False,False,0
39922.0,41,1,29,12,59,19,1,36,156,2,3,0,4,7,8,False,False,0
33402.0,72,2,26,2,19,10,5,8,70,3,2,1,3,6,8,False,False,0
36408.0,75,2,9,1,4,3,2,3,22,1,1,0,2,3,6,False,True,0
51876.0,66,0,99,27,102,28,48,6,310,1,2,2,8,12,1,False,False,2
52852.0,67,1,714,8,99,11,0,47,879,4,10,7,5,22,8,False,False,1
69401.0,51,1,399,27,159,58,8,39,690,4,4,4,5,13,2,False,True,1
46053.0,52,1,56,10,92,19,7,25,209,3,3,2,4,9,5,False,False,0
40304.0,57,1,37,0,17,0,0,3,57,1,2,0,3,5,7,True,True,0
32727.0,59,0,167,13,180,86,13,70,529,2,7,3,5,15,8,False,True,1
68695.0,55,0,458,81,356,106,50,40,1091,1,4,4,7,15,2,False,False,2
43300.0,53,1,91,3,52,2,1,31,180,3,4,0,4,8,8,True,False,0
26290.0,52,2,15,8,16,11,5,22,77,4,2,0,4,6,6,False,False,0
38410.0,50,0,153,64,123,116,64,14,534,2,5,2,9,16,6,False,True,2
64866.0,74,1,508,5,21,7,5,10,556,4,7,3,7,17,5,True,True,1
57957.0,65,1,290,59,177,77,5,29,637,7,4,6,8,18,3,False,False,2
46015.0,69,2,38,0,2,0,0,6,46,1,1,0,3,4,7,False,True,0
16531.0,46,1,2,13,6,7,5,11,44,3,3,0,3,6,7,False,False,0
28072.0,38,1,30,0,10,2,0,5,47,1,1,0,3,4,7,False,True,0
50725.0,71,1,443,10,75,0,10,48,586,4,8,1,8,17,8,False,False,1
41145.0,74,2,9,0,3,0,0,1,13,1,0,0,3,3,3,False,True,0
67419.0,54,1,846,84,352,91,56,42,1471,4,9,4,8,21,5,False,False,2
23162.0,54,2,8,3,9,19,4,22,65,3,1,1,3,5,6,False,True,0
34380.0,47,1,72,7,58,13,1,24,175,4,4,1,3,8,8,False,False,0
34704.0,58,1,29,0,5,0,1,5,40,1,1,0,3,4,5,True,False,0
39898.0,70,1,69,8,26,12,7,12,134,2,3,0,4,7,7,False,False,0
59892.0,54,1,73,0,13,0,1,0,87,1,2,1,3,6,3,False,True,0
41020.0,37,0,112,1,54,7,7,36,217,1,3,2,4,9,3,True,True,0
57072.0,63,1,944,0,60,0,0,30,1034,2,7,5,13,25,5,False,True,1
19414.0,43,1,2,3,12,3,5,7,32,1,1,0,3,4,8,False,True,0
19107.0,44,1,2,4,9,10,5,16,46,2,1,0,3,4,7,False,False,0
70379.0,48,1,553,25,142,65,67,8,860,3,6,3,13,22,4,True,True,2
64014.0,78,3,406,0,30,0,0,8,444,7,8,2,5,15,7,False,True,1
49854.0,52,1,123,17,171,39,0,30,380,5,6,2,5,13,6,False,True,1
60585.0,53,2,267,42,309,55,42,21,736,10,7,4,9,20,5,False,True,1
42873.0,74,2,209,0,40,3,2,15,269,4,6,1,4,11,8,True,True,1
57867.0,46,1,344,35,178,15,23,17,612,7,7,2,9,18,6,False,False,1
35765.0,34,1,22,3,30,0,5,15,75,2,2,0,4,6,6,False,False,0
32952.0,47,1,38,0,12,3,1,1,55,1,2,0,3,5,7,True,False,0
31163.0,51,1,2,3,10,11,2,10,38,1,1,0,3,4,6,True,True,0
42014.0,47,1,244,15,108,4,15,50,436,6,7,1,6,14,8,False,False,1
49667.0,69,0,1181,26,120,17,13,39,1396,2,5,10,5,20,8,True,True,1
63206.0,50,0,750,8,125,11,8,26,928,1,4,3,6,13,2,False,True,1
53977.0,66,1,620,16,165,0,24,82,907,5,5,5,12,22,5,False,False,1
46098.0,49,2,57,0,27,0,0,36,120,4,3,2,2,7,8,True,True,0
20981.0,47,0,2,12,10,6,13,30,73,1,3,1,2,6,8,False,True,0
51766.0,44,1,60,51,87,6,20,51,275,2,4,2,4,10,5,True,False,1
55759.0,62,1,675,0,85,10,7,77,854,5,10,3,8,21,8,False,False,1
33039.0,46,1,30,8,12,8,8,12,78,1,2,0,4,6,5,False,False,0
37787.0,52,1,40,1,40,4,3,18,106,1,3,0,3,6,8,False,True,0
37697.0,48,1,34,6,21,11,4,8,84,1,2,1,3,6,6,True,False,0
37401.0,51,1,19,3,19,3,1,3,48,2,2,0,3,5,7,False,True,0
58597.0,48,2,490,0,184,10,28,21,733,12,7,4,9,20,7,False,False,1
28087.0,66,2,53,8,17,13,0,21,112,3,2,2,2,6,7,False,False,0
19740.0,64,1,7,11,3,10,4,20,55,2,1,1,3,5,5,False,False,0
53083.0,66,2,215,7,33,3,0,13,271,6,5,1,5,11,7,False,True,1
69283.0,49,1,674,62,134,0,26,8,904,4,7,3,13,23,5,False,True,1
46098.0,49,2,57,0,27,0,0,36,120,4,3,2,2,7,8,True,True,0
23331.0,36,1,5,36,7,0,10,45,103,2,3,0,3,6,8,False,True,0
9255.0,35,1,9,0,7,2,0,4,22,1,1,1,2,4,8,True,False,0
71969.0,53,1,1000,0,76,0,0,10,1086,3,3,4,9,16,8,False,True,1
59235.0,57,1,448,40,469,80,0,91,1128,3,11,2,12,25,7,True,True,2
31928.0,35,1,33,4,24,4,2,5,72,2,3,0,4,7,7,False,False,0
74881.0,63,2,505,72,270,36,27,54,964,4,9,2,12,23,5,False,True,2
51411.0,71,3,14,0,3,0,0,1,18,1,0,0,3,3,5,True,True,0
51983.0,60,1,631,0,115,10,7,30,793,3,9,2,10,21,7,True,False,1
42386.0,38,1,65,4,16,0,4,11,100,1,3,0,3,6,8,False,True,0
30390.0,37,0,10,12,12,25,1,20,80,1,2,0,3,5,6,False,True,0
30983.0,61,0,51,4,50,12,1,49,167,1,4,0,3,7,8,True,False,0
66033.0,67,1,293,35,179,46,59,65,677,2,8,3,7,18,7,True,False,2
37284.0,49,2,11,1,2,2,1,6,23,1,0,0,3,3,6,False,True,0
57530.0,73,1,50,1,27,6,7,1,92,1,1,1,4,6,1,True,True,0
37054.0,57,2,12,1,6,0,1,5,25,2,1,0,3,4,7,False,True,0
47175.0,62,2,167,2,44,6,2,19,240,7,4,2,4,10,8,False,True,1
31859.0,48,1,3,1,3,8,0,5,20,1,1,0,2,3,7,True,False,0
27215.0,63,3,30,5,22,8,9,28,102,4,2,1,4,7,6,True,False,0
39922.0,41,1,29,12,59,19,1,36,156,2,3,0,4,7,8,False,False,0
49681.0,48,2,411,0,26,0,0,21,458,6,7,1,7,15,7,False,True,1
24645.0,36,1,5,3,4,4,1,0,17,1,1,0,2,3,8,False,False,0
44322.0,39,1,46,0,40,3,0,3,92,2,3,0,3,6,8,False,False,0
47958.0,72,1,268,11,88,15,3,22,407,2,6,3,5,14,5,True,False,1
63972.0,60,1,928,63,254,0,12,12,1269,4,5,4,10,19,4,True,True,2
75315.0,70,1,459,15,171,142,23,31,841,2,5,4,12,21,2,False,False,2
75283.0,67,3,733,9,180,12,19,66,1019,11,6,3,5,14,4,False,True,1
82800.0,78,0,1006,22,115,59,68,45,1315,1,7,6,12,25,3,True,True,2
38998.0,70,2,34,1,14,0,0,5,54,3,2,0,3,5,8,False,False,0
27161.0,38,1,7,4,23,7,0,11,52,1,1,0,3,4,7,False,True,0
42014.0,47,1,244,15,108,4,15,50,436,6,7,1,6,14,8,False,False,1
38201.0,64,1,233,0,23,0,0,12,268,4,5,1,5,11,8,False,True,1
45203.0,42,2,35,3,67,10,8,24,147,1,3,1,3,7,6,False,False,0
81574.0,77,0,1252,0,465,46,35,0,1798,1,4,5,8,17,1,False,True,2
34935.0,32,0,34,4,66,3,10,20,137,1,2,1,4,7,7,False,False,0
60482.0,48,1,255,43,134,37,14,24,507,1,7,2,7,16,7,True,True,1
34633.0,68,3,8,1,5,0,0,1,15,1,1,0,2,3,6,False,False,0
45903.0,58,1,33,8,10,2,10,3,66,2,2,1,3,6,4,False,True,0
81361.0,37,0,163,23,424,27,65,76,778,1,3,10,13,26,1,True,False,2
35860.0,51,2,15,0,8,4,2,20,49,2,1,1,2,4,5,True,True,0
40442.0,72,2,45,12,52,25,22,13,169,4,3,1,4,8,7,False,True,0
61482.0,59,0,48,58,68,16,66,43,299,1,3,2,6,11,2,False,False,2
34968.0,44,1,158,6,45,8,2,2,221,7,3,2,5,10,7,False,False,0
31497.0,62,1,108,1,28,13,1,4,155,2,3,1,4,8,8,False,True,0
45143.0,59,1,202,5,74,11,5,14,311,3,6,1,5,12,7,False,True,1
52569.0,57,1,85,0,3,0,0,7,95,1,2,0,4,6,3,True,True,0
48432.0,51,1,322,3,50,4,3,42,424,5,7,1,6,14,8,True,True,1
17144.0,64,2,18,2,19,0,2,6,47,5,3,0,4,7,7,False,True,0
36663.0,49,1,18,0,6,3,3,5,35,1,1,1,3,5,2,False,True,0
53843.0,59,1,378,0,88,19,4,73,562,4,8,5,3,16,7,False,True,1
70638.0,69,0,1016,12,215,16,12,63,1334,1,4,5,10,19,3,True,True,2
44512.0,64,2,23,1,6,0,0,2,32,2,1,0,3,4,4,False,False,0
27116.0,63,2,12,1,21,2,2,3,41,2,2,0,3,5,7,False,False,0
54072.0,61,2,35,0,4,0,0,0,39,1,2,0,2,4,8,False,True,0
60432.0,51,1,365,3,15,4,3,11,401,5,7,2,5,14,6,False,True,1
65526.0,60,1,397,19,69,12,0,9,506,1,4,4,8,16,2,False,True,1
33955.0,49,1,100,2,128,23,7,10,270,4,5,1,5,11,8,True,False,0
31353.0,47,2,10,0,10,3,1,7,31,2,1,1,2,4,8,False,False,0
55434.0,40,1,238,115,215,169,69,76,882,3,5,3,13,21,4,False,False,2
28359.0,41,1,6,0,5,2,1,2,16,1,1,0,2,3,7,False,False,0
57100.0,37,1,158,11,99,15,11,17,311,2,3,2,7,12,3,True,False,0
69139.0,59,1,86,12,75,33,15,6,227,1,4,1,5,10,4,False,False,0
51717.0,59,1,98,1,17,0,1,5,122,1,3,0,4,7,7,False,True,0
18793.0,53,1,4,16,20,0,17,20,77,3,2,0,4,6,8,False,False,0
54414.0,61,2,109,18,16,24,26,18,211,4,3,1,5,9,4,False,False,1
54549.0,72,1,216,2,6,0,0,9,233,2,5,1,4,10,7,False,True,0
41003.0,61,0,123,133,142,71,44,88,601,1,6,2,8,16,6,True,True,2
19444.0,42,1,16,0,23,3,2,10,54,3,4,1,2,7,7,False,False,0
36301.0,48,1,11,12,35,3,5,12,78,1,3,0,3,6,7,False,True,0
42731.0,55,1,159,2,51,6,2,24,244,3,4,1,5,10,5,False,True,0
52854.0,65,2,105,0,10,0,1,0,116,2,2,1,4,7,5,False,True,0
22775.0,46,1,5,1,8,0,0,1,15,1,1,0,2,3,8,False,False,0
46681.0,76,2,269,15,69,15,19,38,425,2,4,6,4,14,5,False,True,1
59821.0,69,1,629,0,70,0,0,35,734,6,11,2,7,20,8,False,True,1
50002.0,70,1,443,5,71,21,16,82,638,2,8,2,7,17,7,True,False,1
69755.0,79,0,217,77,373,111,23,93,894,1,3,6,12,21,1,False,False,2
44078.0,55,2,24,1,10,2,0,4,41,2,2,0,3,5,5,False,False,0
30560.0,48,1,9,1,5,4,5,7,31,1,1,0,3,4,7,False,True,0
35924.0,55,2,8,0,14,2,3,7,34,1,1,0,3,4,5,False,True,0
24594.0,45,1,1,3,6,10,0,9,29,1,1,0,3,4,5,False,False,0
75774.0,43,1,340,21,134,258,14,56,823,1,7,5,8,20,4,False,True,2
39228.0,64,0,7,1,6,0,3,3,20,1,0,0,3,3,4,True,True,0
58494.0,50,1,298,7,68,4,0,19,396,2,6,2,6,14,6,False,True,1
58684.0,43,0,479,35,179,28,7,85,813,1,5,3,12,20,2,True,False,2
56551.0,74,2,67,4,32,17,2,16,138,3,2,1,4,7,4,True,True,0
22448.0,42,1,3,1,8,23,2,18,55,3,2,1,3,6,3,False,False,0
25358.0,77,1,19,0,5,0,0,8,32,2,1,0,3,4,6,True,True,0
35544.0,46,1,30,5,23,4,1,4,67,1,2,0,3,5,7,True,True,0
36634.0,70,1,213,9,76,4,3,30,335,3,5,2,5,12,7,False,True,1
62670.0,70,1,539,30,92,80,46,38,825,1,5,3,13,21,3,False,True,2
50729.0,66,2,239,13,143,45,4,52,496,9,6,2,7,15,6,True,True,1
64892.0,48,1,527,24,230,32,24,65,902,2,6,4,12,22,4,True,False,2
43602.0,58,2,19,5,12,10,3,19,68,3,3,1,2,6,6,True,False,0
33996.0,35,0,40,2,15,8,0,6,71,1,1,1,3,5,4,True,True,0
41473.0,39,1,21,8,20,15,3,9,76,1,2,0,3,5,7,True,True,0
63246.0,57,2,593,30,91,29,22,7,772,1,6,3,12,21,4,False,True,1
36732.0,65,2,21,5,3,10,1,7,47,3,1,1,4,6,2,False,True,0
69084.0,54,1,1181,107,199,39,30,30,1586,2,7,3,13,23,8,False,True,2
77766.0,57,1,1004,59,265,115,59,27,1529,2,11,10,11,32,6,False,True,2
37929.0,39,0,202,2,46,3,2,10,265,2,4,2,5,11,7,True,True,0
20193.0,33,0,8,8,22,24,11,9,82,1,1,1,4,6,4,False,True,0
27573.0,49,1,50,15,110,39,15,15,244,4,5,1,4,10,8,False,False,0
15862.0,45,1,1,1,4,11,9,10,36,1,1,0,3,4,8,True,False,0
49544.0,48,1,308,0,73,0,0,23,404,2,5,1,8,14,7,False,True,1
33228.0,44,1,22,2,31,7,4,5,71,1,2,0,3,5,7,False,False,0
38232.0,53,2,43,5,28,7,6,33,122,4,3,1,3,7,5,False,False,0
22554.0,69,2,27,0,10,0,0,4,41,4,2,0,4,6,5,False,True,0
23536.0,41,1,6,0,3,0,0,1,10,1,0,0,3,3,3,False,True,0
49413.0,72,1,205,7,41,3,2,46,304,2,4,2,5,11,5,False,False,1
42231.0,55,2,24,0,8,0,1,4,37,1,1,0,3,4,5,False,False,0
56534.0,56,1,691,7,61,10,0,46,815,4,10,4,7,21,8,False,False,1
81217.0,35,0,493,70,324,146,40,84,1157,1,3,7,11,21,1,True,False,2
61787.0,37,0,621,73,414,78,48,85,1319,1,8,4,6,18,5,True,True,2
18169.0,39,1,9,0,5,0,0,7,21,1,1,0,2,3,8,False,True,0
24336.0,43,1,1,6,2,8,2,12,31,1,1,0,2,3,7,True,True,0
18222.0,34,0,12,4,19,12,6,14,67,1,2,0,3,5,8,False,False,0
62335.0,72,1,243,131,217,85,6,26,708,2,3,3,13,19,2,True,False,2
42033.0,53,2,11,1,4,2,0,7,25,1,1,0,2,3,7,False,True,0
86580.0,41,0,532,21,127,26,20,20,746,0,4,2,5,11,1,False,True,2
41437.0,67,2,29,0,2,0,0,1,32,1,1,0,3,4,7,True,True,0
38452.0,69,2,56,0,14,0,0,2,72,3,3,0,3,6,7,False,True,0
18358.0,35,1,6,8,19,16,4,4,57,3,3,0,4,7,7,True,False,0
55012.0,51,1,582,0,65,0,0,13,660,6,8,2,9,19,5,False,True,1
9722.0,51,1,6,17,16,6,16,42,103,4,3,1,3,7,8,False,False,0
38175.0,40,1,70,6,69,2,3,3,153,3,3,1,4,8,7,False,True,0
58656.0,68,1,962,12,194,16,24,12,1220,4,7,8,13,28,6,False,True,1
52117.0,59,1,112,10,107,30,0,20,279,2,5,2,4,11,7,False,False,1
54222.0,51,1,199,12,31,3,12,7,264,1,3,3,5,11,3,False,True,0
41154.0,46,1,44,2,11,2,3,7,69,1,1,0,4,5,5,False,False,0
18746.0,32,1,2,10,11,12,9,20,64,2,3,0,3,6,6,True,False,0
22108.0,47,2,5,3,9,6,2,6,31,2,2,0,3,5,7,False,False,0
44392.0,50,2,87,5,71,7,12,29,211,5,4,1,4,9,7,False,False,1
17688.0,45,1,2,2,1,3,1,2,11,1,1,0,2,3,8,False,False,0
38513.0,42,1,172,3,115,16,0,18,324,5,6,1,5,12,8,True,True,1
16653.0,45,1,5,7,31,15,4,7,69,3,2,1,3,6,6,True,True,0
42586.0,69,2,194,2,56,0,0,0,252,5,4,1,6,11,8,False,False,1
23529.0,59,1,9,7,13,3,2,20,54,1,1,1,2,4,6,True,False,0
74881.0,63,2,505,72,270,36,27,54,964,4,9,2,12,23,5,False,True,2
46910.0,60,2,48,0,14,0,0,6,68,2,2,0,3,5,6,False,True,0
18690.0,65,0,6,1,7,23,4,19,60,1,1,1,2,4,8,False,False,0
37244.0,69,2,18,2,10,0,0,25,55,1,1,1,2,4,7,True,False,0
70044.0,70,1,1073,0,250,153,14,14,1504,4,7,10,5,22,5,True,False,2
79146.0,57,2,245,16,223,21,43,16,564,2,8,1,8,17,6,True,False,1
77437.0,61,0,560,21,442,29,44,29,1125,1,4,5,13,22,1,False,False,2
54984.0,65,1,173,13,131,32,3,6,358,4,6,1,6,13,7,False,False,1
42403.0,53,1,22,1,11,0,5,3,42,1,1,0,3,4,8,False,True,0
55761.0,60,1,136,1,12,0,3,32,184,2,4,1,3,8,6,False,False,0
37292.0,41,1,275,0,86,10,23,66,460,5,6,3,5,14,8,False,False,1
45576.0,79,0,56,19,29,2,14,25,145,1,3,1,3,7,8,True,True,0
58086.0,55,1,708,7,62,0,0,15,792,2,11,3,7,21,8,True,True,1
28389.0,77,0,1,5,3,7,4,8,28,1,1,0,2,3,7,False,False,0
80360.0,75,0,1493,86,454,112,43,43,2231,2,4,4,5,13,2,False,True,2
63342.0,63,1,918,21,118,13,10,21,1101,3,8,3,5,16,6,False,True,1
31859.0,44,1,3,4,7,15,8,11,48,1,1,0,3,4,7,True,True,0
51569.0,75,1,380,0,47,6,0,34,467,4,7,1,7,15,8,True,True,1
30372.0,53,2,15,0,12,7,3,7,44,3,2,0,3,5,7,True,False,0
16014.0,45,2,3,9,4,7,8,7,38,4,1,1,4,6,3,True,False,0
41120.0,56,2,24,2,23,0,8,24,81,3,2,1,3,6,6,False,False,0
38725.0,69,2,31,0,6,2,1,5,45,2,1,0,4,5,4,False,True,0
13533.0,45,1,12,3,8,8,0,17,48,2,2,0,3,5,7,True,True,0
59481.0,49,1,178,3,85,71,66,58,461,2,3,3,8,14,2,False,False,2
72117.0,47,1,707,20,171,65,60,50,1073,1,9,7,9,25,5,False,False,2
21955.0,38,1,5,1,7,17,14,11,55,2,2,1,3,6,6,False,True,0
67131.0,68,1,465,71,250,93,35,62,976,3,9,2,12,23,6,False,False,2
36802.0,44,1,16,1,2,0,0,1,20,1,1,0,3,4,5,True,True,0
28249.0,63,0,1,9,7,2,14,10,43,1,2,0,3,5,6,False,False,0
47808.0,49,1,123,1,26,2,0,72,224,2,3,2,3,8,7,False,True,0
51012.0,78,0,102,9,63,2,9,24,209,1,4,1,4,9,6,False,True,0
85431.0,72,0,376,53,462,168,53,53,1165,1,2,7,7,16,0,False,True,2
42664.0,57,1,21,0,3,0,0,0,24,1,1,0,3,4,6,False,False,0
42586.0,69,2,194,2,56,0,0,0,252,5,4,1,6,11,8,False,False,1
29760.0,39,1,64,4,68,7,5,17,165,4,3,1,4,8,8,True,False,0
28973.0,47,0,206,0,46,3,2,12,269,2,5,1,5,11,8,False,True,0
39435.0,51,1,71,0,18,0,0,13,102,1,3,1,2,6,7,False,True,0
20194.0,45,1,0,4,7,11,10,15,47,2,2,0,3,5,6,True,False,0
42473.0,48,2,93,1,21,0,4,25,144,3,2,1,4,7,5,True,True,0
64590.0,56,0,920,138,168,36,46,30,1338,1,9,4,10,23,6,False,False,2
71232.0,65,1,653,17,170,34,26,17,917,2,11,2,10,23,7,False,False,1
34600.0,53,2,199,33,60,8,3,15,318,5,5,2,5,12,8,False,False,1
46904.0,57,2,153,4,56,0,9,31,253,4,5,1,4,10,8,True,False,1
49094.0,51,1,376,0,38,11,8,69,502,5,6,3,6,15,6,False,False,1
36075.0,41,1,46,0,30,12,1,30,119,1,2,0,4,6,6,False,False,0
77298.0,45,1,425,115,292,23,35,79,969,1,6,6,11,23,3,False,False,2
34026.0,74,2,18,6,15,12,8,17,76,3,2,1,3,6,5,False,False,0
48918.0,61,2,52,0,9,0,0,1,62,2,1,0,4,5,4,True,True,0
37697.0,48,1,34,6,21,11,4,8,84,1,2,1,3,6,6,True,False,0
34074.0,72,2,135,1,41,10,1,67,255,5,3,3,3,9,6,False,False,1
28520.0,64,2,11,0,10,0,2,20,43,1,1,1,2,4,6,False,True,0
62535.0,69,1,163,48,90,0,45,52,398,1,3,2,8,13,3,True,False,2
36273.0,47,1,29,3,30,3,2,9,76,2,3,0,3,6,6,True,True,0
63404.0,60,2,734,26,70,11,44,17,902,2,6,3,4,13,4,False,False,1
75774.0,43,1,340,21,134,258,14,56,823,1,7,5,8,20,4,False,True,2
59385.0,73,2,135,0,10,0,4,36,185,2,3,1,4,8,5,False,True,0
37070.0,58,2,231,7,137,4,15,39,433,9,5,1,8,14,7,True,False,1
44689.0,73,2,18,0,5,0,0,11,34,2,1,1,2,4,7,False,False,0
53977.0,66,1,620,16,165,0,24,82,907,5,5,5,12,22,5,False,False,1
18701.0,60,2,12,4,2,10,6,10,44,4,2,0,4,6,5,True,False,0
37758.0,58,2,27,2,10,0,0,1,40,2,1,0,3,4,8,False,False,0
79734.0,55,0,572,8,232,23,62,17,914,1,4,3,6,13,1,False,True,2
50387.0,68,2,369,9,87,12,14,34,525,3,6,2,8,16,5,False,False,1
32583.0,63,2,5,0,3,0,0,1,9,1,1,0,2,3,7,False,True,0
62568.0,62,1,362,17,398,80,35,61,953,3,5,3,5,13,4,False,False,2
44635.0,53,2,56,0,9,0,0,3,68,2,2,0,3,5,7,True,True,0
33316.0,53,2,79,1,31,4,4,12,131,3,2,1,4,7,6,True,True,0
25293.0,55,1,15,0,11,0,2,9,37,1,1,1,2,4,8,False,False,0
54111.0,59,1,267,6,54,8,3,50,388,2,5,2,6,13,5,True,True,1
44911.0,65,1,159,0,22,2,1,31,215,3,4,1,4,9,7,False,False,0
54693.0,62,1,686,17,142,23,26,35,929,8,6,4,13,23,6,False,True,1
48186.0,50,1,97,3,66,12,7,34,219,3,4,1,4,9,7,False,False,0
54809.0,47,2,63,6,57,13,13,22,174,4,2,1,5,8,4,False,False,0
41580.0,46,2,56,5,24,4,0,3,92,3,2,1,3,6,5,False,False,0
47743.0,67,1,198,2,43,0,12,20,275,3,4,1,6,11,6,False,False,1
27071.0,56,1,8,3,19,0,2,3,35,2,2,0,3,5,6,True,True,0
68148.0,67,0,389,66,408,37,57,85,1042,1,4,4,6,14,2,False,True,2
65735.0,59,2,239,7,119,4,15,11,395,5,6,2,6,14,7,False,True,1
86836.0,49,0,179,21,273,0,21,63,557,1,6,10,6,22,5,False,True,2
30093.0,34,0,2,6,28,13,4,16,69,1,2,0,3,5,7,False,False,0
57705.0,58,1,383,0,53,6,4,40,486,3,8,1,6,15,6,False,True,1
25008.0,36,1,2,8,8,6,1,9,34,2,1,0,3,4,8,True,False,0
22280.0,49,1,2,1,4,3,1,2,13,1,1,0,2,3,8,False,False,0
82733.0,40,0,712,50,420,65,38,38,1323,1,8,4,7,19,4,True,True,2
74290.0,53,1,1121,0,72,0,12,12,1217,4,10,8,10,28,6,True,True,1
58217.0,73,3,68,1,13,3,5,13,103,1,2,0,4,6,6,True,True,0
21024.0,48,0,36,4,18,6,2,18,84,1,2,0,4,6,7,False,True,0
69063.0,58,1,666,35,124,69,8,26,928,1,5,3,5,13,3,False,True,2
11448.0,49,0,0,0,0,6,2,6,14,1,1,0,2,3,6,True,True,0
61825.0,45,1,162,50,100,55,30,27,424,1,4,2,8,14,4,True,False,2
69109.0,42,0,823,25,459,124,29,95,1555,1,6,6,7,19,4,False,False,2
60208.0,51,2,488,23,71,15,0,59,656,11,8,3,7,18,7,True,False,1
32889.0,56,2,28,0,13,4,2,8,55,3,2,1,3,6,5,False,True,0
34738.0,40,1,3,2,10,3,0,2,20,1,1,0,3,4,6,True,False,0
26642.0,57,1,13,2,15,2,2,8,42,2,2,0,3,5,6,True,True,0
44503.0,52,2,31,1,8,0,0,8,48,2,2,0,3,5,6,True,False,0
60200.0,76,1,502,19,132,0,6,26,685,6,6,2,11,19,6,True,True,1
49638.0,72,1,18,10,3,3,5,0,39,1,1,0,3,4,2,True,False,0
23830.0,37,0,1,8,6,4,8,16,43,1,1,0,3,4,7,True,True,0
69702.0,73,1,664,9,240,50,19,57,1039,2,7,7,10,24,4,False,True,2
70300.0,49,1,1045,61,338,60,46,46,1596,3,5,5,13,23,8,True,False,2
30396.0,55,1,15,0,6,0,1,12,34,2,1,1,2,4,7,False,True,0
50616.0,56,1,128,0,16,0,1,4,149,2,4,0,4,8,7,True,True,0
30298.0,39,0,6,3,12,6,1,0,28,1,1,1,3,5,3,True,True,0
52413.0,40,1,185,8,133,56,56,12,450,2,7,1,7,15,7,True,False,1
44155.0,67,2,22,1,9,0,0,14,46,1,1,1,2,4,4,False,True,0
42081.0,42,1,175,10,110,54,6,27,382,2,6,3,4,13,6,False,False,1
31158.0,39,1,25,6,16,20,0,5,72,2,2,0,3,5,8,False,False,0
61671.0,56,1,641,7,56,0,0,28,732,8,10,4,6,20,8,True,False,1
69719.0,50,0,273,86,208,177,14,43,801,1,2,3,5,10,1,True,False,2
49160.0,75,1,122,21,43,25,10,15,236,2,3,1,6,10,6,True,False,0
24882.0,46,1,1,4,10,29,0,36,80,1,1,1,2,4,6,False,False,0
90933.0,70,0,1020,31,430,62,63,79,1685,1,4,6,4,14,1,True,True,2
59292.0,74,1,378,14,68,19,14,14,507,2,3,5,8,16,3,False,True,1
45759.0,60,2,42,1,18,3,0,4,68,2,2,0,3,5,7,False,True,0
22148.0,41,0,15,5,14,0,4,11,49,1,1,0,3,4,7,True,False,0
73395.0,37,0,272,7,80,20,7,11,397,1,4,4,6,14,2,False,True,1
29819.0,53,1,9,1,24,2,1,2,39,3,3,0,3,6,6,True,False,0
45688.0,56,1,279,0,18,0,0,9,306,2,3,1,8,12,4,False,False,0
62820.0,70,0,398,61,265,138,61,53,976,1,3,4,6,13,1,False,False,2
60491.0,53,1,637,47,237,12,19,76,1028,4,6,11,7,24,5,False,True,2
33235.0,38,1,45,0,16,2,1,6,70,1,3,0,3,6,7,False,False,0
35701.0,65,0,21,1,9,7,3,5,46,1,1,0,3,4,6,False,False,0
31535.0,44,1,15,4,13,0,0,19,51,1,1,1,2,4,7,False,True,0
92556.0,64,0,493,183,352,184,23,28,1263,0,3,5,13,21,0,False,True,2
18929.0,34,0,32,0,8,23,4,18,85,1,1,0,4,5,6,False,False,0
36038.0,43,1,23,0,15,0,2,7,47,2,3,0,3,6,6,True,True,0
20180.0,48,0,18,42,24,15,20,18,137,1,2,1,4,7,7,True,False,0
34230.0,59,2,15,0,4,0,0,2,21,1,1,0,2,3,7,False,True,0
31878.0,47,1,23,4,5,10,5,23,70,1,1,0,4,5,3,True,True,0
77598.0,81,0,1193,33,281,129,66,33,1735,1,7,5,13,25,3,True,True,2
80982.0,65,2,505,137,401,104,22,22,1191,3,11,5,11,27,5,True,False,2
22701.0,47,1,2,4,9,0,4,5,24,1,1,0,3,4,5,False,True,0
55212.0,55,1,1103,0,45,0,0,34,1182,3,4,2,11,17,8,False,True,1
61917.0,50,2,46,4,36,2,2,1,91,1,2,0,4,6,5,False,True,0
67472.0,77,1,162,31,127,8,17,69,414,2,4,2,7,13,3,False,True,1
21059.0,42,1,8,3,19,3,3,8,44,3,3,0,3,6,6,False,True,0
29543.0,56,2,17,3,18,3,4,18,63,2,3,1,2,6,7,False,True,0
34984.0,49,2,8,4,15,3,5,3,38,2,1,0,3,4,7,False,True,0
54998.0,68,1,154,22,202,39,30,8,455,5,4,2,9,15,4,True,True,1
54356.0,75,1,710,15,30,20,0,0,775,3,11,2,8,21,8,True,True,1
34242.0,65,1,8,2,4,0,0,1,15,1,0,0,3,3,5,False,True,0
25410.0,51,1,2,2,4,13,13,4,38,1,1,0,4,5,4,False,False,0
28320.0,74,1,19,1,14,3,2,4,43,1,1,0,3,4,8,False,False,0
23763.0,47,1,22,0,6,6,2,6,42,1,1,0,3,4,7,True,False,0
34529.0,48,1,68,6,38,3,6,41,162,2,2,2,3,7,7,False,True,0
36065.0,56,2,18,7,34,10,2,3,74,3,3,0,3,6,8,True,False,0
39898.0,70,1,69,8,26,12,7,12,134,2,3,0,4,7,7,False,False,0
51141.0,84,0,144,0,7,0,0,6,157,1,3,1,4,8,5,True,True,0
56939.0,48,1,256,34,103,90,29,49,561,2,3,3,10,16,3,False,False,2
61798.0,60,0,338,4,89,11,8,13,463,1,4,2,9,15,4,True,True,1
76842.0,74,0,605,10,345,84,54,32,1130,1,1,8,7,16,0,True,True,2
29478.0,48,1,8,0,7,3,1,1,20,1,1,0,3,4,6,False,False,0
46998.0,68,1,172,41,86,45,6,27,377,5,5,3,5,13,7,True,False,1
56551.0,74,2,67,4,32,17,2,16,138,3,2,1,4,7,4,True,True,0
44359.0,46,2,20,0,14,7,3,1,45,3,2,0,4,6,3,False,False,0
48877.0,58,1,102,1,15,2,0,24,144,1,3,0,4,7,7,True,False,0
85738.0,46,0,913,26,376,17,26,13,1371,1,3,6,11,20,1,False,True,2
55686.0,58,1,673,0,199,37,47,26,982,2,6,3,5,14,4,True,False,2
39062.0,41,1,23,0,9,0,0,12,44,1,1,0,3,4,4,True,False,0
34600.0,53,2,199,33,60,8,3,15,318,5,5,2,5,12,8,False,False,1
40794.0,49,1,261,23,73,4,23,50,434,2,6,3,5,14,7,False,False,1
54690.0,53,2,111,16,37,7,9,18,198,3,3,1,5,9,3,False,True,0
32632.0,61,0,63,151,137,153,19,53,576,2,4,4,8,16,5,False,True,2
38236.0,56,2,58,0,18,2,0,10,88,4,3,0,4,7,7,True,True,0
36781.0,45,1,29,1,17,0,3,13,63,1,2,1,2,5,8,False,False,0
31385.0,40,1,3,2,12,0,1,9,27,1,1,0,2,3,8,True,True,0
58646.0,62,1,62,1,44,6,5,22,140,1,2,1,4,7,4,False,True,0
53201.0,49,2,280,7,81,20,0,27,415,8,6,3,5,14,7,True,False,1
21994.0,67,1,9,0,6,3,1,3,22,1,0,0,3,3,5,False,False,0
57113.0,46,2,182,4,33,0,2,42,263,6,4,1,5,10,7,False,False,1
23477.0,38,1,38,15,54,3,8,29,147,3,3,0,4,7,8,False,False,0
58116.0,68,1,228,19,130,4,11,51,443,2,3,3,8,14,2,False,False,1
39791.0,53,1,85,15,27,13,13,21,174,2,3,1,4,8,7,False,True,0
13672.0,64,2,6,2,9,2,1,5,25,2,1,0,3,4,8,False,False,0
79205.0,49,0,504,23,117,179,28,44,895,1,6,5,4,15,4,False,False,2
56559.0,49,1,226,22,133,41,31,31,484,3,4,3,8,15,4,False,True,1
32644.0,51,1,239,3,141,0,7,23,413,4,7,1,6,14,8,False,True,1
67506.0,44,1,90,38,67,33,36,67,331,1,4,1,6,11,3,True,True,1
24206.0,54,1,7,2,8,3,2,3,25,1,1,0,3,4,6,True,False,0
28420.0,57,1,4,2,5,2,0,0,13,1,1,0,2,3,6,True,True,0
22979.0,54,1,16,17,19,20,21,22,115,3,3,2,2,7,8,False,False,0
33279.0,58,0,10,3,3,0,0,0,16,1,0,0,3,3,3,True,False,0
46423.0,52,2,68,0,16,0,0,8,92,3,2,0,4,6,7,True,True,0
30368.0,47,1,35,0,13,2,0,2,52,2,2,0,3,5,8,False,False,0
41638.0,60,1,315,0,31,4,0,91,441,4,5,5,3,13,8,True,False,1
68805.0,65,1,182,2,49,17,13,20,283,1,3,1,7,11,2,True,True,1
65814.0,58,1,561,14,113,10,14,35,747,3,8,2,10,20,5,False,True,1
39146.0,38,1,94,1,33,13,12,12,165,3,4,0,4,8,8,True,False,0
68281.0,66,0,995,112,417,42,48,41,1655,1,2,9,13,24,5,True,False,2
37284.0,49,2,11,1,2,2,1,6,23,1,0,0,3,3,6,False,True,0
27943.0,57,2,12,1,16,4,1,3,37,3,2,0,3,5,8,False,False,0
22263.0,73,2,17,0,2,0,0,2,21,2,1,0,3,4,6,True,False,0
30261.0,52,3,8,0,5,0,3,6,22,1,0,0,3,3,8,False,False,0
28587.0,46,1,22,4,17,12,10,13,78,3,2,0,4,6,6,False,False,0
43815.0,42,1,14,10,29,4,7,15,79,1,2,0,3,5,6,False,True,0
48195.0,68,2,106,27,68,52,7,5,265,6,4,2,5,11,6,False,False,1
77027.0,72,1,820,57,242,45,0,11,1175,2,8,3,6,17,4,False,True,2
32765.0,45,1,13,3,17,7,3,3,46,2,2,0,4,6,5,False,True,0
29672.0,59,2,9,1,3,0,4,8,25,1,0,0,3,3,6,False,False,0
23272.0,71,0,19,3,6,4,2,12,46,1,1,0,3,4,4,True,False,0
49912.0,75,1,520,8,223,32,49,42,874,4,10,5,7,22,8,False,True,1
68117.0,77,1,618,44,215,0,17,36,930,2,11,8,4,23,6,True,True,1
17649.0,48,1,15,1,23,0,5,1,45,3,3,0,3,6,8,False,False,0
60905.0,74,1,208,17,76,36,17,38,392,2,3,3,7,13,2,False,False,1
75330.0,47,2,555,82,257,93,61,61,1109,4,10,3,12,25,6,False,False,2
60689.0,73,1,240,90,216,63,6,24,639,4,4,4,10,18,3,True,False,2
38680.0,40,1,11,0,36,15,5,12,79,1,2,0,3,5,7,False,False,0
61416.0,42,0,848,154,323,201,61,78,1665,1,10,3,10,23,6,False,False,2
29009.0,43,1,6,6,15,10,5,2,44,2,2,0,3,5,6,False,False,0
45057.0,45,1,37,0,7,3,0,3,50,1,2,0,3,5,5,False,True,0
43020.0,54,1,45,7,99,4,25,43,223,3,4,1,4,9,6,True,False,1
53154.0,65,1,129,0,21,0,1,7,158,1,3,1,4,8,4,False,False,0
76467.0,54,1,676,161,426,210,44,58,1575,2,2,5,5,12,6,True,False,2
32871.0,73,2,22,2,12,0,2,5,43,1,1,0,3,4,4,False,False,0
55801.0,49,2,367,4,51,6,4,95,527,6,7,2,6,15,7,True,False,1
76320.0,65,1,526,35,214,69,53,35,932,2,6,3,4,13,2,True,False,2
36927.0,69,2,51,0,16,0,0,4,71,2,3,0,3,6,8,True,True,0
48794.0,71,2,25,0,11,3,0,15,54,1,1,0,3,4,4,False,False,0
23478.0,59,0,28,6,27,12,17,39,129,1,3,0,3,6,8,True,False,0
71128.0,51,1,958,159,447,20,0,31,1615,3,2,10,12,24,7,True,False,2
50943.0,55,2,375,42,48,94,66,96,721,7,4,10,4,18,3,False,True,2
38361.0,55,1,39,0,56,20,8,14,137,3,3,1,3,7,7,False,False,0
55212.0,43,1,23,0,15,0,2,7,47,2,3,0,3,6,6,True,True,0
42554.0,46,2,29,1,11,0,0,0,41,2,2,0,3,5,4,False,False,0
42192.0,76,0,40,15,15,17,6,7,100,1,2,1,3,6,4,False,False,0
77610.0,72,1,1245,33,332,21,33,16,1680,2,4,7,4,15,7,False,True,2
31761.0,40,1,19,1,20,16,14,28,98,2,3,0,4,7,5,False,False,0
34350.0,45,1,16,3,15,2,1,11,48,1,1,0,3,4,7,False,False,0
54591.0,75,1,376,4,94,12,9,24,519,3,6,2,8,16,5,False,False,1
71866.0,68,1,184,178,178,103,39,33,715,1,6,3,10,19,3,False,False,2
25293.0,55,1,15,0,11,0,2,9,37,1,1,1,2,4,8,False,False,0
42000.0,37,0,124,83,267,85,59,35,653,2,5,2,11,18,5,True,True,2
64713.0,54,1,180,60,241,13,54,54,602,2,5,5,7,17,4,True,False,2
27889.0,47,1,14,0,4,0,0,8,26,1,1,1,2,4,6,False,True,0
22123.0,64,0,3,3,24,34,7,31,102,1,2,1,3,6,5,True,False,0
52028.5,53,2,71,1,16,0,0,9,97,4,2,1,3,6,8,False,False,0
50943.0,70,1,161,0,22,0,0,24,207,2,4,1,4,9,6,False,True,0
27803.0,51,1,8,26,46,38,9,49,176,2,3,0,4,7,8,False,False,0
51651.0,64,1,293,6,23,13,6,92,433,4,6,2,5,13,8,False,False,1
56796.0,55,1,656,38,161,62,47,37,1001,3,8,9,7,24,7,False,False,2
30828.0,44,1,16,11,15,2,0,12,56,2,1,1,4,6,3,True,False,0
34109.0,53,1,9,1,5,2,1,4,22,1,0,0,3,3,4,False,True,0
53367.0,50,2,229,7,140,10,3,11,400,7,5,1,8,14,7,True,True,1
22390.0,55,0,0,1,4,15,1,5,26,1,1,0,2,3,7,False,False,0
71322.0,48,1,121,24,124,24,15,42,350,1,4,1,7,12,2,False,False,1
49912.0,75,1,520,8,223,32,49,42,874,4,10,5,7,22,8,False,True,1
48699.0,74,2,26,1,10,2,0,1,40,1,1,0,3,4,5,False,True,0
54252.0,68,2,178,4,26,8,4,44,264,5,4,1,5,10,6,True,False,1
76068.0,49,1,1115,12,128,33,12,76,1376,1,2,3,4,9,6,False,False,1
53204.0,48,2,29,0,8,2,0,6,45,1,1,0,3,4,4,False,True,0
67911.0,75,1,529,0,356,63,28,0,976,3,6,7,11,24,3,False,True,2
78128.0,50,1,934,24,230,16,24,36,1264,2,8,4,6,18,3,False,True,2
14188.0,52,0,2,7,11,16,12,27,75,1,2,0,4,6,6,False,False,0
20425.0,38,1,4,12,5,3,16,17,57,2,2,0,3,5,7,False,False,0
58646.0,62,1,62,1,44,6,5,22,140,1,2,1,4,7,4,False,True,0
48150.0,75,1,173,2,39,3,2,47,266,3,5,1,4,10,7,False,True,1
58275.0,69,2,189,10,253,56,43,64,615,6,8,2,7,17,7,True,False,1
34587.0,71,2,7,2,9,2,0,2,22,2,1,0,3,4,4,False,False,0
43018.0,50,1,35,4,17,7,6,64,133,1,2,2,2,6,5,False,True,0
45736.0,70,1,188,3,180,20,3,43,437,5,7,1,6,14,7,False,True,1
66476.0,55,1,742,28,152,25,9,57,1013,2,6,8,10,24,4,False,True,2
27733.0,43,1,0,7,5,26,2,17,57,2,2,0,3,5,7,False,True,0
69805.0,72,1,750,71,174,13,10,20,1038,2,6,8,11,25,2,False,True,2
25818.0,53,1,5,2,8,2,2,9,28,1,0,1,2,3,7,True,False,0
37509.0,48,1,37,5,56,12,8,5,123,2,3,0,4,7,7,False,True,0
25176.0,48,2,4,0,4,0,0,5,13,1,1,0,2,3,7,False,True,0
43586.0,44,1,99,2,11,4,0,16,132,3,3,0,4,7,8,False,False,0
50116.0,67,2,54,0,10,0,0,2,66,2,1,0,4,5,5,False,False,0
84906.0,52,0,997,15,414,99,30,76,1631,1,5,6,12,23,2,False,False,2
65220.0,59,0,890,63,292,0,25,12,1282,4,8,4,7,19,6,False,True,2
33590.0,50,3,4,0,2,0,0,2,8,1,1,0,2,3,7,False,False,0
30992.0,48,1,17,0,14,7,3,2,43,1,1,0,3,4,7,True,False,0
16005.0,44,1,1,3,2,20,30,47,103,3,2,1,2,5,8,False,False,0
58692.0,59,1,301,11,61,4,7,11,395,1,8,2,4,14,7,False,False,1
40590.0,55,2,154,0,50,6,11,37,258,5,3,4,3,10,6,True,False,1
20587.0,54,1,2,3,6,4,1,9,25,1,1,1,2,4,7,True,False,0
62637.0,70,1,104,12,48,4,12,5,185,1,2,2,5,9,2,True,True,0
19346.0,50,1,2,0,9,3,6,2,22,1,1,0,3,4,8,True,False,0
35788.0,53,2,23,2,11,3,1,4,44,2,2,0,3,5,6,False,False,0
36997.0,56,2,43,4,12,8,0,27,94,5,2,1,4,7,5,True,False,0
23539.0,67,0,4,24,11,16,1,25,81,1,2,0,4,6,6,False,False,0
65333.0,51,1,654,7,92,0,15,30,798,7,9,4,8,21,6,True,False,1
41275.0,64,3,24,4,22,0,2,9,61,4,3,1,3,7,5,False,True,0
63516.0,51,2,141,11,114,15,14,5,300,4,4,1,7,12,5,False,True,1
42769.0,62,1,71,0,13,3,1,0,88,2,1,1,4,6,4,False,True,0
49572.0,66,2,35,1,16,0,1,1,54,2,2,0,3,5,7,False,True,0
17148.0,48,1,9,9,11,13,10,16,68,4,3,1,3,7,8,False,False,0
40590.0,55,2,154,0,50,6,11,37,258,5,3,4,3,10,6,True,False,1
30560.0,48,1,9,1,5,4,5,7,31,1,1,0,3,4,7,False,True,0
32146.0,41,1,26,3,23,4,7,3,66,2,2,0,4,6,6,False,True,0
41713.0,60,2,77,8,44,10,10,25,174,5,3,1,4,8,6,True,True,0
34176.0,49,1,11,2,7,4,2,2,28,1,1,0,3,4,3,False,True,0
58482.0,69,1,576,7,115,19,7,7,731,2,7,4,9,20,6,False,True,1
59686.0,59,1,89,15,89,34,42,5,274,1,4,1,6,11,4,True,False,1
62994.0,44,1,224,12,48,4,12,12,312,1,6,2,4,12,6,False,False,0
47320.0,67,1,200,19,111,50,15,19,414,6,5,1,8,14,6,False,False,1
15253.0,32,1,1,3,3,8,1,13,29,2,1,0,3,4,7,True,False,0
31560.0,50,1,62,1,20,4,0,7,94,2,2,1,3,6,8,True,True,0
41967.0,43,2,23,4,10,0,2,15,54,1,1,0,3,4,4,True,False,0
69263.0,59,1,492,5,32,13,5,21,568,1,9,1,7,17,6,True,False,1
65210.0,69,1,626,0,70,0,7,28,731,2,9,3,8,20,6,False,False,1
38946.0,69,1,116,6,82,6,6,41,257,2,3,1,6,10,5,False,False,0
26067.0,50,1,22,2,18,0,2,12,56,3,3,0,3,6,8,False,False,0
44325.0,52,1,516,0,21,0,0,5,542,4,8,2,7,17,8,False,True,1
42523.0,60,0,14,36,11,3,26,35,125,1,1,1,4,6,2,False,False,0
26487.0,46,1,2,8,10,12,14,23,69,3,2,1,3,6,5,True,False,0
53233.0,67,1,28,0,9,3,0,0,40,1,1,0,3,4,4,False,True,0
67716.0,64,1,530,142,217,62,9,56,1016,4,7,4,13,24,5,False,False,2
76234.0,52,1,519,50,167,130,0,41,907,1,8,3,11,22,3,False,True,2
25224.0,52,1,4,9,12,11,2,8,46,2,1,1,3,5,3,False,False,0
40851.0,53,2,23,1,7,0,4,24,59,1,1,1,2,4,7,True,False,0
27469.0,77,0,9,1,2,3,2,0,17,1,0,0,3,3,6,False,False,0
8820.0,72,2,12,0,13,4,2,4,35,4,3,0,3,6,8,True,True,0
43322.0,50,0,56,7,48,10,2,18,141,1,3,0,4,7,7,True,False,0
37085.0,49,2,39,1,16,2,0,3,61,4,3,0,3,6,8,False,False,0
16185.0,34,1,5,11,16,21,8,45,106,2,2,2,2,6,8,True,False,0
57731.0,55,1,266,21,300,65,8,44,704,4,8,8,6,22,6,True,False,2
18929.0,34,0,32,0,8,23,4,18,85,1,1,0,4,5,6,False,False,0
35893.0,56,2,158,0,23,0,0,18,199,6,3,1,5,9,8,True,False,0
32144.0,70,2,41,0,10,0,0,3,54,4,2,1,3,6,7,False,False,0
14918.0,61,1,3,3,3,15,4,15,43,1,1,0,3,4,6,False,False,0
45146.0,61,2,33,0,5,0,0,15,53,2,1,1,2,4,4,True,False,0
41769.0,69,1,302,29,131,32,0,27,521,6,8,1,7,16,8,True,True,1
38054.0,74,2,23,2,17,2,1,0,45,2,2,0,3,5,7,True,True,0
36807.0,70,2,4,2,5,0,0,5,16,1,1,0,2,3,6,False,False,0
28427.0,41,1,18,3,19,3,3,6,52,2,2,0,3,5,8,False,False,0
22775.0,46,1,5,1,8,0,0,1,15,1,1,0,2,3,8,False,False,0
40101.0,39,1,171,3,129,26,24,62,415,4,6,1,6,13,7,False,True,1
58025.0,45,1,270,31,88,11,48,22,470,3,3,2,10,15,4,False,False,1
7500.0,45,1,2,8,11,3,8,21,53,4,3,2,2,7,7,False,True,0
33562.0,61,3,21,12,12,0,3,3,51,3,2,0,4,6,4,False,True,0
57642.0,54,1,580,6,58,8,0,27,679,3,7,6,6,19,4,True,True,1
58554.0,56,2,368,24,68,38,0,88,586,6,8,2,6,16,7,False,False,1
63777.0,45,2,457,5,106,15,17,53,653,8,11,1,6,18,8,False,False,1
57967.0,62,1,229,7,137,4,0,91,468,5,4,2,8,14,5,True,False,1
24434.0,52,2,3,2,8,20,0,17,50,2,2,1,2,5,7,False,False,0
44802.0,54,0,853,10,143,13,10,20,1049,2,9,4,12,25,8,True,True,1
26816.0,38,0,5,1,6,3,4,3,22,1,0,0,3,3,4,True,False,0
34421.0,50,1,3,3,7,6,2,9,30,1,1,0,2,3,7,False,False,0
64014.0,78,3,406,0,30,0,0,8,444,7,8,2,5,15,7,False,True,1
56981.0,43,0,908,48,217,32,12,24,1241,1,2,3,13,18,6,True,False,2
69245.0,68,1,428,30,214,80,30,61,843,2,6,5,10,21,3,False,True,2
52869.0,70,2,84,3,61,2,1,21,172,3,3,1,4,8,7,False,True,0
